"id","employees","employees_f","employees_m","turnover","size","industry"
5,110,13,97,237306.65327914,"big","B"
14,171,1,170,7934.05728216863,"big","B"
25,142,81,61,408964.032176683,"big","B"
120,160,120,40,261086.011305039,"big","B"
125,257,17,240,423543.459122786,"big","B"
161,103,76,27,340763.608286894,"big","B"
164,116,8,108,81968.1111227042,"big","B"
168,215,10,205,323047.225049544,"big","B"
222,193,116,77,510756.119377398,"big","B"
227,177,108,69,90594.3837828125,"big","B"
245,130,46,84,227530.286787659,"big","B"
280,241,51,190,24025.6829559624,"big","B"
290,129,38,91,9715.02474959557,"big","B"
333,161,92,69,134880.91710782,"big","B"
388,138,45,93,18763.6140806163,"big","B"
493,119,12,107,128559.764531026,"big","B"
537,209,68,141,375355.480034349,"big","B"
545,128,37,91,200664.12744613,"big","B"
550,158,156,2,83831.4114050435,"big","B"
603,106,22,84,102205.272030676,"big","B"
610,132,112,20,395340.739449728,"big","B"
611,137,25,112,94252.4858313437,"big","B"
614,119,35,84,216473.422393415,"big","B"
685,110,44,66,205294.728214247,"big","B"
691,105,68,37,71794.4046349725,"big","B"
702,115,68,47,125437.750334996,"big","B"
791,132,85,47,37435.3293726248,"big","B"
795,191,107,84,100014.164224721,"big","B"
837,193,156,37,221819.663511184,"big","B"
842,102,59,43,116654.060647911,"big","B"
866,195,182,13,144094.585432375,"big","B"
875,110,76,34,59942.1713320119,"big","B"
885,301,218,83,296594.819554612,"big","B"
928,119,105,14,34508.1478906522,"big","B"
1003,214,133,81,253628.507959953,"big","B"
1108,141,4,137,146935.201733331,"big","B"
1117,101,15,86,126917.038524379,"big","B"
1138,112,34,78,163411.743433757,"big","B"
1143,169,102,67,194375.193529572,"big","B"
1155,144,27,117,484510.262223818,"big","B"
1173,182,148,34,238537.200458526,"big","B"
1183,172,125,47,274173.199334276,"big","B"
1213,126,105,21,129067.212123329,"big","B"
1215,139,81,58,46407.6926910753,"big","B"
1223,232,220,12,102226.485644414,"big","B"
1251,105,53,52,203644.42725316,"big","B"
1282,222,61,161,481113.686538892,"big","B"
1372,115,114,1,157331.314920722,"big","B"
1385,103,70,33,135141.746792922,"big","B"
1386,155,45,110,176815.402518534,"big","B"
1419,206,125,81,473421.045917777,"big","B"
1427,162,128,34,421114.431114161,"big","B"
1445,190,180,10,42968.7470110217,"big","B"
1556,107,84,23,60979.3000961653,"big","B"
1581,120,79,41,112335.450167565,"big","B"
1620,211,180,31,677392.572677781,"big","B"
1622,109,100,9,160795.808579145,"big","B"
1644,122,101,21,115708.899997772,"big","B"
1680,281,229,52,617082.304099154,"big","B"
1773,194,105,89,93278.4476215496,"big","B"
1887,154,94,60,140860.251781789,"big","B"
1903,222,21,201,332800.440735815,"big","B"
1932,244,128,116,433147.253697486,"big","B"
1959,204,37,167,125619.299621867,"big","B"
1980,221,56,165,253353.300344657,"big","B"
2001,51,19,32,13175.3799226441,"mid","C"
2002,140,120,20,95056.4615552248,"big","C"
2003,61,27,34,29971.2872749468,"mid","C"
2004,48,9,39,24123.9494928146,"mid","C"
2005,99,22,77,13861.1383386684,"mid","C"
2006,84,16,68,162886.978959941,"mid","C"
2007,219,67,152,515513.865969671,"big","C"
2008,63,53,10,44613.8453941807,"mid","C"
2009,37,35,2,59612.5572622502,"mid","C"
2010,89,55,34,77825.1343812958,"mid","C"
2011,107,93,14,96334.6093168651,"big","C"
2012,6,5,1,9230.09684132276,"small","C"
2013,61,61,0,154464.885080406,"mid","C"
2014,34,18,16,30675.8972767479,"mid","C"
2015,228,227,1,189559.595421329,"big","C"
2016,10,5,5,11529.9200022542,"small","C"
2017,54,51,3,54489.3243379356,"mid","C"
2018,18,2,16,5720.9382834401,"mid","C"
2019,7,6,1,5782.18190261381,"small","C"
2020,150,46,104,108115.094775125,"big","C"
2021,276,151,125,447278.726126092,"big","C"
2022,4,2,2,6438.49979998921,"small","C"
2023,60,12,48,20544.1404318461,"mid","C"
2024,138,70,68,135878.80718793,"big","C"
2025,88,29,59,85459.4790165182,"mid","C"
2026,62,60,2,25640.113018296,"mid","C"
2027,13,1,12,6014.14760613296,"mid","C"
2028,146,98,48,125493.464594709,"big","C"
2029,68,64,4,14621.4079481201,"mid","C"
2030,131,14,117,237665.506227253,"big","C"
2031,43,12,31,49085.6920361439,"mid","C"
2032,105,64,41,128201.132369723,"big","C"
2033,108,61,47,40030.3795222334,"big","C"
2034,74,40,34,47933.7739377726,"mid","C"
2035,18,3,15,17611.2921603082,"mid","C"
2036,143,42,101,295469.998264844,"big","C"
2037,66,43,23,132659.576717898,"mid","C"
2038,16,13,3,39775.8247537766,"mid","C"
2039,120,44,76,238575.505403521,"big","C"
2040,39,31,8,61349.9013422897,"mid","C"
2041,19,6,13,29679.4828394849,"mid","C"
2042,85,41,44,26477.6779211376,"mid","C"
2043,2,1,1,3709.8872340291,"small","C"
2044,45,12,33,92111.3356331419,"mid","C"
2045,190,104,86,321833.179053395,"big","C"
2046,179,126,53,20717.6169452295,"big","C"
2047,116,110,6,104431.558272088,"big","C"
2048,112,74,38,150904.885982441,"big","C"
2049,96,29,67,173834.070509824,"mid","C"
2050,108,45,63,67244.1890905448,"big","C"
2051,10,8,2,21224.8193046683,"small","C"
2052,21,15,6,17521.6164054062,"mid","C"
2053,100,21,79,27565.4343488882,"mid","C"
2054,79,9,70,103670.037347253,"mid","C"
2055,56,12,44,114328.596650424,"mid","C"
2056,92,14,78,10270.5766263234,"mid","C"
2057,67,22,45,157774.792669645,"mid","C"
2058,62,2,60,27722.2874271337,"mid","C"
2059,116,34,82,73119.0161484279,"big","C"
2060,40,37,3,79888.2731139142,"mid","C"
2061,30,23,7,25448.1675910837,"mid","C"
2062,127,90,37,32371.8100685019,"big","C"
2063,42,3,39,40550.8145619422,"mid","C"
2064,29,18,11,43570.9203273405,"mid","C"
2065,86,55,31,61240.2418881161,"mid","C"
2066,117,57,60,162593.644417396,"big","C"
2067,5,5,0,10737.9083101488,"small","C"
2068,28,6,22,5318.04642284342,"mid","C"
2069,75,9,66,74480.434918758,"mid","C"
2070,14,6,8,28425.2717187629,"mid","C"
2071,185,72,113,460264.692608067,"big","C"
2072,75,31,44,70979.653745403,"mid","C"
2073,18,5,13,26186.3688666865,"mid","C"
2074,44,12,32,47772.7895239496,"mid","C"
2075,46,23,23,13447.5133119066,"mid","C"
2076,34,5,29,633.569227822539,"mid","C"
2077,32,20,12,43805.1902706081,"mid","C"
2078,45,19,26,63996.0760785297,"mid","C"
2079,64,53,11,20736.2732737615,"mid","C"
2080,24,19,5,23033.5753836959,"mid","C"
2081,54,43,11,81850.3623280233,"mid","C"
2082,112,4,108,3214.11438916715,"big","C"
2083,92,14,78,136342.805920242,"mid","C"
2084,107,21,86,100676.179828072,"big","C"
2085,132,125,7,69042.6993248986,"big","C"
2086,149,20,129,327438.664738748,"big","C"
2087,122,45,77,202651.280840794,"big","C"
2088,192,153,39,208893.841406577,"big","C"
2089,225,30,195,846794.294668272,"big","C"
2090,13,9,4,8216.2040696695,"mid","C"
2091,52,34,18,114340.164792901,"mid","C"
2092,64,17,47,75292.7740654151,"mid","C"
2093,111,57,54,304028.327867756,"big","C"
2094,35,11,24,71203.0600315594,"mid","C"
2095,126,56,70,24164.4512071457,"big","C"
2096,239,34,205,82126.9110299799,"big","C"
2097,58,21,37,105280.986823725,"mid","C"
2098,94,92,2,132207.502816964,"mid","C"
2099,199,40,159,147024.950492641,"big","C"
2100,216,174,42,56821.3511344914,"big","C"
2101,30,17,13,27577.8386180521,"mid","C"
2102,37,33,4,11090.5725905168,"mid","C"
2103,261,37,224,107771.481036931,"big","C"
2104,32,29,3,6176.80342716704,"mid","C"
2105,58,25,33,68901.6308471047,"mid","C"
2106,25,14,11,2877.24394911426,"mid","C"
2107,103,64,39,265290.709555862,"big","C"
2108,90,29,61,24068.8056298476,"mid","C"
2109,167,98,69,95789.3722494112,"big","C"
2110,76,65,11,164193.369268746,"mid","C"
2111,46,33,13,53067.0722862536,"mid","C"
2112,107,49,58,83383.2639664124,"big","C"
2113,14,12,2,2372.79302678767,"mid","C"
2114,109,81,28,121551.490017293,"big","C"
2115,3,1,2,2447.6704326618,"small","C"
2116,75,42,33,82313.0412570979,"mid","C"
2117,68,17,51,74091.2227314198,"mid","C"
2118,91,14,77,49998.0843375045,"mid","C"
2119,45,31,14,66013.4641571096,"mid","C"
2120,167,67,100,377203.839101069,"big","C"
2121,32,11,21,60719.5021778122,"mid","C"
2122,87,57,30,12987.0609387327,"mid","C"
2123,175,171,4,107576.394832264,"big","C"
2124,7,1,6,13007.3956637035,"small","C"
2125,54,23,31,15073.8622867477,"mid","C"
2126,57,4,53,44425.4460639268,"mid","C"
2127,66,15,51,124364.565907892,"mid","C"
2128,108,97,11,50522.2289026206,"big","C"
2129,70,67,3,121130.74837954,"mid","C"
2130,43,33,10,14838.2332071145,"mid","C"
2131,38,8,30,45498.409525305,"mid","C"
2132,46,28,18,71763.1597022111,"mid","C"
2133,3,1,2,4592.8793775897,"small","C"
2134,227,221,6,34472.6910532386,"big","C"
2135,213,73,140,249975.864250923,"big","C"
2136,48,3,45,10458.0454030669,"mid","C"
2137,216,59,157,199155.594785128,"big","C"
2138,66,17,49,96924.2474454356,"mid","C"
2139,78,22,56,39819.2862000503,"mid","C"
2140,140,64,76,62223.6069236166,"big","C"
2141,27,1,26,7426.89184777973,"mid","C"
2142,5,0,5,3883.33732740828,"small","C"
2143,33,16,17,21296.7789023828,"mid","C"
2144,210,47,163,263893.422495259,"big","C"
2145,42,35,7,90226.6270703564,"mid","C"
2146,115,103,12,287291.016336158,"big","C"
2147,79,55,24,146298.722617505,"mid","C"
2148,89,54,35,89187.636821607,"mid","C"
2149,107,107,0,153897.369622672,"big","C"
2150,98,95,3,13814.9867738187,"mid","C"
2151,26,24,2,25181.3575969264,"mid","C"
2152,38,10,28,108785.727175747,"mid","C"
2153,102,91,11,238497.248791155,"big","C"
2154,95,76,19,220679.584593377,"mid","C"
2155,67,24,43,51847.3717591012,"mid","C"
2156,185,116,69,3769.60155285278,"big","C"
2157,229,122,107,209021.736295929,"big","C"
2158,17,11,6,3576.88708652561,"mid","C"
2159,88,21,67,41119.724854773,"mid","C"
2160,129,121,8,310009.226485183,"big","C"
2161,72,63,9,131204.471608083,"mid","C"
2162,125,13,112,231995.84721298,"big","C"
2163,28,12,16,8424.78551271175,"mid","C"
2164,152,23,129,380060.263848527,"big","C"
2165,148,34,114,177144.813639301,"big","C"
2166,97,28,69,16027.0442654641,"mid","C"
2167,40,22,18,66981.002705489,"mid","C"
2168,24,14,10,16048.6478126653,"mid","C"
2169,101,86,15,91604.9695792585,"big","C"
2170,14,0,14,20580.598130134,"mid","C"
2171,2,2,0,1087.84561277209,"small","C"
2172,6,1,5,5521.69789050251,"small","C"
2173,221,196,25,184870.054965974,"big","C"
2174,107,61,46,72875.7510063855,"big","C"
2175,43,39,4,47978.2603278976,"mid","C"
2176,5,4,1,5445.19169647486,"small","C"
2177,19,18,1,34916.8369108035,"mid","C"
2178,84,9,75,59777.391238903,"mid","C"
2179,136,24,112,111954.20172323,"big","C"
2180,131,95,36,431151.743648662,"big","C"
2181,196,71,125,340076.456971059,"big","C"
2182,197,130,67,220788.161256716,"big","C"
2183,195,80,115,451929.793931257,"big","C"
2184,3,3,0,642.10324510544,"small","C"
2185,55,51,4,46991.854090875,"mid","C"
2186,44,21,23,50059.4401356503,"mid","C"
2187,242,217,25,466165.666587803,"big","C"
2188,171,3,168,368283.032575558,"big","C"
2189,152,116,36,252654.890970944,"big","C"
2190,89,80,9,281190.590463751,"mid","C"
2191,92,26,66,76158.5812204294,"mid","C"
2192,70,42,28,105433.5013863,"mid","C"
2193,25,2,23,20919.637632438,"mid","C"
2194,90,45,45,122003.57584068,"mid","C"
2195,16,15,1,2745.38514028797,"mid","C"
2196,72,59,13,17258.2441188595,"mid","C"
2197,28,1,27,4451.06611204664,"mid","C"
2198,144,120,24,79954.5135400259,"big","C"
2199,112,65,47,266385.887105465,"big","C"
2200,77,57,20,186646.583997132,"mid","C"
2201,41,18,23,63265.7491533079,"mid","C"
2202,126,119,7,212711.362834356,"big","C"
2203,159,79,80,324602.703261693,"big","C"
2204,118,108,10,195227.123993867,"big","C"
2205,6,1,5,7793.64877726572,"small","C"
2206,92,25,67,76021.4378802178,"mid","C"
2207,51,19,32,41266.5342848545,"mid","C"
2208,53,13,40,55187.6947822626,"mid","C"
2209,5,4,1,1943.31823796387,"small","C"
2210,5,2,3,4739.79430946292,"small","C"
2211,59,42,17,38162.9557900934,"mid","C"
2212,60,45,15,4684.32251544821,"mid","C"
2213,7,4,3,1045.44169628492,"small","C"
2214,117,26,91,116538.783712946,"big","C"
2215,37,31,6,21930.8469172212,"mid","C"
2216,90,49,41,219003.861227072,"mid","C"
2217,90,19,71,179623.605316153,"mid","C"
2218,91,44,47,54568.044709132,"mid","C"
2219,44,20,24,49193.7384775969,"mid","C"
2220,185,44,141,117497.27707698,"big","C"
2221,112,62,50,98207.1870840798,"big","C"
2222,91,50,41,170185.767822497,"mid","C"
2223,54,3,51,715.058520644131,"mid","C"
2224,30,3,27,20305.7824302433,"mid","C"
2225,150,84,66,363349.020140697,"big","C"
2226,48,21,27,46733.7197536372,"mid","C"
2227,38,29,9,141225.675748674,"mid","C"
2228,60,53,7,33772.067665312,"mid","C"
2229,34,26,8,11331.4004955415,"mid","C"
2230,71,17,54,49362.0856487488,"mid","C"
2231,118,18,100,211003.569120562,"big","C"
2232,138,123,15,346054.075515246,"big","C"
2233,109,62,47,19703.9941075486,"big","C"
2234,21,17,4,45202.5665871192,"mid","C"
2235,85,25,60,102879.113716466,"mid","C"
2236,187,89,98,96108.7828356056,"big","C"
2237,56,16,40,79736.0876409524,"mid","C"
2238,71,3,68,46532.9253039656,"mid","C"
2239,19,12,7,20815.1791975707,"mid","C"
2240,144,71,73,311465.904132971,"big","C"
2241,73,2,71,136179.757113968,"mid","C"
2242,19,11,8,13142.1197695208,"mid","C"
2243,54,23,31,42973.9371434494,"mid","C"
2244,28,0,28,25356.2634697738,"mid","C"
2245,59,46,13,129223.131715865,"mid","C"
2246,59,7,52,44025.6154017181,"mid","C"
2247,3,2,1,2963.24308633771,"small","C"
2248,48,21,27,99928.6110276355,"mid","C"
2249,116,13,103,210367.722511952,"big","C"
2250,22,10,12,21028.9282437763,"mid","C"
2251,25,4,21,16173.053894598,"mid","C"
2252,79,58,21,156407.07132396,"mid","C"
2253,243,5,238,131910.867001266,"big","C"
2254,185,9,176,133795.534230906,"big","C"
2255,146,13,133,325883.458260465,"big","C"
2256,157,69,88,378052.620308088,"big","C"
2257,15,0,15,32140.3323456616,"mid","C"
2258,2,2,0,5748.38992731406,"small","C"
2259,91,20,71,822.676256433239,"mid","C"
2260,35,8,27,32570.3472425632,"mid","C"
2261,42,22,20,75582.8936110728,"mid","C"
2262,16,5,11,26104.8157769726,"mid","C"
2263,320,79,241,769259.843523329,"big","C"
2264,108,104,4,120359.680401736,"big","C"
2265,123,64,59,192799.921179802,"big","C"
2266,42,29,13,61387.6368186969,"mid","C"
2267,21,5,16,9675.01197882214,"mid","C"
2268,151,50,101,206978.170934172,"big","C"
2269,204,192,12,138423.228914435,"big","C"
2270,23,8,15,15743.2422835037,"mid","C"
2271,155,6,149,334197.349287215,"big","C"
2272,42,19,23,6746.29958711455,"mid","C"
2273,99,7,92,8517.45498492118,"mid","C"
2274,4,3,1,3347.80632162758,"small","C"
2275,123,91,32,196544.366303197,"big","C"
2276,126,49,77,57061.1470816919,"big","C"
2277,31,3,28,21289.9191992105,"mid","C"
2278,45,41,4,38190.479223958,"mid","C"
2279,90,44,46,34553.5918291422,"mid","C"
2280,54,10,44,58787.1952473992,"mid","C"
2281,89,53,36,156744.782323858,"mid","C"
2282,83,80,3,70656.6788580771,"mid","C"
2283,168,83,85,401249.883306674,"big","C"
2284,87,71,16,152481.954411921,"mid","C"
2285,185,44,141,56940.1859489285,"big","C"
2286,108,88,20,93141.9697774295,"big","C"
2287,81,81,0,124990.410153624,"mid","C"
2288,113,31,82,109823.954735145,"big","C"
2289,66,64,2,3499.91723283858,"mid","C"
2290,199,31,168,354263.553976113,"big","C"
2291,1,0,1,2134.11295496835,"small","C"
2292,71,23,48,76816.9727517523,"mid","C"
2293,68,20,48,187166.833126733,"mid","C"
2294,8,7,1,16522.3588554035,"small","C"
2295,114,14,100,115954.973229706,"big","C"
2296,99,94,5,45841.7223032973,"mid","C"
2297,119,75,44,42179.7278686285,"big","C"
2298,31,20,11,81242.627429494,"mid","C"
2299,158,13,145,256079.036930935,"big","C"
2300,251,113,138,227984.414717383,"big","C"
2301,14,1,13,6093.04057376419,"mid","C"
2302,231,53,178,219277.753343016,"big","C"
2303,9,7,2,7077.61870928419,"small","C"
2304,37,26,11,27647.4309777922,"mid","C"
2305,35,3,32,45381.6407306397,"mid","C"
2306,4,4,0,9824.37539879097,"small","C"
2307,157,149,8,167009.062280008,"big","C"
2308,33,31,2,6906.70838406133,"mid","C"
2309,121,22,99,163107.470051759,"big","C"
2310,108,13,95,5595.4089732608,"big","C"
2311,70,69,1,42571.3331666142,"mid","C"
2312,74,11,63,74893.999451315,"mid","C"
2313,77,34,43,106347.416362635,"mid","C"
2314,52,9,43,88656.7184007355,"mid","C"
2315,62,3,59,25532.1149728995,"mid","C"
2316,47,2,45,35705.8497122992,"mid","C"
2317,69,48,21,187421.484698647,"mid","C"
2318,140,18,122,1359.57890810118,"big","C"
2319,119,42,77,189447.797032122,"big","C"
2320,241,86,155,400774.468252939,"big","C"
2321,68,37,31,198481.322157386,"mid","C"
2322,14,10,4,43954.1344189844,"mid","C"
2323,12,9,3,7030.69380022685,"mid","C"
2324,168,6,162,221457.940838696,"big","C"
2325,64,42,22,110726.764344515,"mid","C"
2326,156,103,53,95271.0930381893,"big","C"
2327,27,6,21,51180.0900577154,"mid","C"
2328,26,12,14,14205.5007971827,"mid","C"
2329,98,32,66,36488.3835955851,"mid","C"
2330,106,48,58,56508.882844499,"big","C"
2331,81,75,6,165903.950096493,"mid","C"
2332,60,47,13,125061.579210388,"mid","C"
2333,55,9,46,4995.59150687865,"mid","C"
2334,61,30,31,34384.3589067807,"mid","C"
2335,33,5,28,2175.09572059214,"mid","C"
2336,60,57,3,52540.1624226576,"mid","C"
2337,75,19,56,75609.9830618326,"mid","C"
2338,92,62,30,180381.253472883,"mid","C"
2339,243,185,58,760740.707362748,"big","C"
2340,111,53,58,18757.3526342948,"big","C"
2341,213,48,165,239515.583959573,"big","C"
2342,46,33,13,56650.8114003493,"mid","C"
2343,22,6,16,40532.4881047132,"mid","C"
2344,4,2,2,5367.82950323981,"small","C"
2345,118,22,96,18975.4712214936,"big","C"
2346,50,29,21,32891.3752999118,"mid","C"
2347,152,28,124,128994.692231761,"big","C"
2348,132,69,63,124529.944503614,"big","C"
2349,137,92,45,185719.848907092,"big","C"
2350,49,17,32,98655.7049678846,"mid","C"
2351,69,11,58,19129.2061918092,"mid","C"
2352,23,21,2,50056.3102707552,"mid","C"
2353,32,13,19,38477.7274062202,"mid","C"
2354,76,19,57,35500.4749097373,"mid","C"
2355,27,21,6,39597.6757849827,"mid","C"
2356,84,44,40,26801.2940240689,"mid","C"
2357,6,3,3,3961.00574042967,"small","C"
2358,227,221,6,79381.2759831388,"big","C"
2359,50,20,30,64379.9668355559,"mid","C"
2360,55,33,22,75460.8093463478,"mid","C"
2361,144,59,85,142622.877915531,"big","C"
2362,29,1,28,33961.1755889701,"mid","C"
2363,79,16,63,157482.927904693,"mid","C"
2364,90,61,29,216809.506024788,"mid","C"
2365,6,2,4,16708.779219372,"small","C"
2366,8,1,7,1420.64389853808,"small","C"
2367,24,17,7,13135.5763722332,"mid","C"
2368,19,16,3,40169.8952635474,"mid","C"
2369,210,158,52,547016.332182405,"big","C"
2370,200,83,117,84682.2552012156,"big","C"
2371,30,10,20,19866.5677872696,"mid","C"
2372,73,17,56,72793.800416495,"mid","C"
2373,64,33,31,106281.00073947,"mid","C"
2374,82,75,7,78160.5197600818,"mid","C"
2375,73,64,9,86766.9891189423,"mid","C"
2376,56,26,30,110623.218940117,"mid","C"
2377,85,12,73,155054.601039883,"mid","C"
2378,182,111,71,65743.1539719369,"big","C"
2379,1,0,1,1171.75250103328,"small","C"
2380,21,6,15,1346.78265502283,"mid","C"
2381,33,13,20,77275.8759097437,"mid","C"
2382,133,45,88,24208.5418570138,"big","C"
2383,197,117,80,277614.366931048,"big","C"
2384,229,36,193,132655.258625622,"big","C"
2385,55,51,4,11715.5567363212,"mid","C"
2386,194,13,181,302076.779901702,"big","C"
2387,158,127,31,294657.864785699,"big","C"
2388,181,175,6,277080.106517279,"big","C"
2389,162,61,101,31143.2087497369,"big","C"
2390,150,66,84,421199.167898226,"big","C"
2391,50,38,12,5281.8635066156,"mid","C"
2392,111,80,31,176482.06363592,"big","C"
2393,90,70,20,73404.7510993399,"mid","C"
2394,45,30,15,28205.8003349893,"mid","C"
2395,89,14,75,171635.571200936,"mid","C"
2396,61,50,11,56458.5534352884,"mid","C"
2397,5,4,1,6929.39641319877,"small","C"
2398,90,59,31,128318.044511517,"mid","C"
2399,175,167,8,168456.814536169,"big","C"
2400,77,74,3,37203.338356403,"mid","C"
2401,266,146,120,146873.653459348,"big","C"
2402,21,8,13,31100.4467210354,"mid","C"
2403,79,65,14,63389.9177752514,"mid","C"
2404,175,6,169,215575.246435555,"big","C"
2405,2,0,2,249.065093278709,"small","C"
2406,331,154,177,192466.762466128,"big","C"
2407,80,55,25,107275.386481803,"mid","C"
2408,163,158,5,184317.581639423,"big","C"
2409,49,19,30,17300.9443340376,"mid","C"
2410,77,38,39,12526.7000314928,"mid","C"
2411,99,53,46,115561.130129775,"mid","C"
2412,15,1,14,35916.719296891,"mid","C"
2413,6,3,3,23195.3840962879,"small","C"
2414,1,0,1,132.092567095378,"small","C"
2415,62,37,25,84096.6907842846,"mid","C"
2416,5,4,1,11867.0506215466,"small","C"
2417,7,1,6,21628.3061570289,"small","C"
2418,160,33,127,188112.899117532,"big","C"
2419,53,11,42,151979.16340836,"mid","C"
2420,60,50,10,29939.2956254604,"mid","C"
2421,85,37,48,89193.3482728205,"mid","C"
2422,39,5,34,111604.108213634,"mid","C"
2423,15,10,5,2681.3941498534,"mid","C"
2424,9,2,7,12204.0854350328,"small","C"
2425,83,21,62,116929.716230299,"mid","C"
2426,191,183,8,205120.014685671,"big","C"
2427,84,71,13,17667.0347371625,"mid","C"
2428,117,25,92,117523.666529498,"big","C"
2429,169,124,45,184018.183907773,"big","C"
2430,29,19,10,1222.43233837235,"mid","C"
2431,244,150,94,234110.995244573,"big","C"
2432,118,90,28,146682.035994222,"big","C"
2433,32,5,27,31311.1944693379,"mid","C"
2434,82,24,58,39431.4037328051,"mid","C"
2435,153,142,11,85884.1686467924,"big","C"
2436,68,4,64,38549.4325420778,"mid","C"
2437,17,5,12,42229.1405618645,"mid","C"
2438,4,2,2,382.124713008257,"small","C"
2439,129,56,73,180523.735088668,"big","C"
2440,75,25,50,149635.895289468,"mid","C"
2441,55,12,43,52165.3714150102,"mid","C"
2442,61,37,24,53182.3073537926,"mid","C"
2443,157,51,106,109844.951955819,"big","C"
2444,76,75,1,102399.313904708,"mid","C"
2445,55,39,16,105812.863069207,"mid","C"
2446,7,4,3,15382.4273811957,"small","C"
2447,66,12,54,170976.625695957,"mid","C"
2448,85,22,63,183125.331493454,"mid","C"
2449,51,3,48,104431.500162319,"mid","C"
2450,75,31,44,29704.474227429,"mid","C"
2451,186,76,110,372352.319374282,"big","C"
2452,35,14,21,11945.2609010513,"mid","C"
2453,76,35,41,149269.790622054,"mid","C"
2454,91,22,69,142052.076071452,"mid","C"
2455,109,104,5,292166.184534147,"big","C"
2456,70,26,44,94846.5831513162,"mid","C"
2457,76,15,61,35278.7885319937,"mid","C"
2458,10,1,9,3410.03562934522,"small","C"
2459,168,159,9,137136.479146679,"big","C"
2460,91,7,84,134001.338064393,"mid","C"
2461,51,46,5,24221.8884299505,"mid","C"
2462,47,12,35,40841.5271011145,"mid","C"
2463,97,40,57,165778.098597958,"mid","C"
2464,72,59,13,24429.8548724325,"mid","C"
2465,4,2,2,4174.59118577531,"small","C"
2466,18,15,3,13117.5161101786,"mid","C"
2467,101,24,77,28683.2463746546,"big","C"
2468,63,20,43,65784.3741021878,"mid","C"
2469,47,16,31,66917.5433106844,"mid","C"
2470,109,98,11,55265.5861908701,"big","C"
2471,122,90,32,426096.560016894,"big","C"
2472,61,61,0,36658.4146673052,"mid","C"
2473,177,96,81,376738.720102098,"big","C"
2474,16,6,10,20218.3398998986,"mid","C"
2475,84,50,34,141216.35316765,"mid","C"
2476,198,99,99,38303.9636524597,"big","C"
2477,36,9,27,18354.7644077609,"mid","C"
2478,133,7,126,383884.849142645,"big","C"
2479,271,251,20,369549.557270767,"big","C"
2480,89,17,72,81211.6925040558,"mid","C"
2481,94,5,89,120662.600285932,"mid","C"
2482,46,9,37,1803.73757175861,"mid","C"
2483,58,29,29,110735.913200702,"mid","C"
2484,130,36,94,311537.910662044,"big","C"
2485,87,78,9,146779.503441203,"mid","C"
2486,188,131,57,511284.046742801,"big","C"
2487,19,3,16,28698.3484794423,"mid","C"
2488,2,0,2,4954.47408038433,"small","C"
2489,50,20,30,109380.915328391,"mid","C"
2490,22,8,14,35894.3892276823,"mid","C"
2491,79,11,68,30693.568559206,"mid","C"
2492,136,103,33,252970.910381878,"big","C"
2493,101,22,79,234412.269897894,"big","C"
2494,73,20,53,30413.8921685779,"mid","C"
2495,53,6,47,185498.179470761,"mid","C"
2496,14,11,3,8487.21960342142,"mid","C"
2497,69,6,63,56983.7575674523,"mid","C"
2498,10,2,8,8244.91122088258,"small","C"
2499,387,377,10,212534.398206632,"big","C"
2500,156,79,77,191995.536889358,"big","C"
2501,35,33,2,25111.4128306143,"mid","C"
2502,105,31,74,2706.77142393028,"big","C"
2503,59,15,44,113948.530485873,"mid","C"
2504,39,6,33,70153.7425511476,"mid","C"
2505,40,25,15,12156.8174311446,"mid","C"
2506,5,5,0,4941.02578602579,"small","C"
2507,148,94,54,140691.537418529,"big","C"
2508,102,62,40,146821.113306904,"big","C"
2509,24,13,11,6521.1447525188,"mid","C"
2510,68,28,40,120604.482655023,"mid","C"
2511,10,9,1,16709.2677226862,"small","C"
2512,62,57,5,5289.77613522005,"mid","C"
2513,61,53,8,36746.1738348379,"mid","C"
2514,137,68,69,194991.036597712,"big","C"
2515,86,43,43,19049.0682564711,"mid","C"
2516,104,46,58,5429.72249322776,"big","C"
2517,8,2,6,3411.49726191059,"small","C"
2518,8,6,2,13256.4267765485,"small","C"
2519,25,21,4,17898.5755855983,"mid","C"
2520,22,16,6,24728.9452561214,"mid","C"
2521,89,62,27,35873.4119268842,"mid","C"
2522,171,53,118,66574.49493367,"big","C"
2523,72,67,5,23984.7080629686,"mid","C"
2524,99,58,41,151991.244311413,"mid","C"
2525,139,40,99,16379.6996821679,"big","C"
2526,26,17,9,43400.5996008727,"mid","C"
2527,110,24,86,289921.757109867,"big","C"
2528,180,11,169,127992.02953068,"big","C"
2529,153,63,90,115844.301755615,"big","C"
2530,100,24,76,157734.533293405,"mid","C"
2531,67,48,19,52751.539990257,"mid","C"
2532,48,46,2,153157.745845132,"mid","C"
2533,160,110,50,319979.485796828,"big","C"
2534,212,105,107,315731.704892726,"big","C"
2535,58,1,57,67401.8443234945,"mid","C"
2536,13,6,7,13877.411719881,"mid","C"
2537,47,27,20,106907.002486447,"mid","C"
2538,76,29,47,46745.7101266277,"mid","C"
2539,86,52,34,110854.722087713,"mid","C"
2540,24,21,3,7757.18518399823,"mid","C"
2541,74,56,18,19886.3345568459,"mid","C"
2542,169,2,167,114319.46716074,"big","C"
2543,81,69,12,68441.2961600344,"mid","C"
2544,78,28,50,77094.3937393674,"mid","C"
2545,76,58,18,38084.1933513482,"mid","C"
2546,27,24,3,2663.78387918632,"mid","C"
2547,42,37,5,24026.1219237216,"mid","C"
2548,35,31,4,69511.8035656063,"mid","C"
2549,61,14,47,127265.318130819,"mid","C"
2550,115,75,40,122757.074936384,"big","C"
2551,29,18,11,2752.2512955617,"mid","C"
2552,28,13,15,11291.0594613751,"mid","C"
2553,23,10,13,36617.3633149512,"mid","C"
2554,45,22,23,88742.820555931,"mid","C"
2555,146,6,140,180854.841051084,"big","C"
2556,239,108,131,117474.292462463,"big","C"
2557,48,7,41,22116.5277975933,"mid","C"
2558,93,66,27,23695.3741482219,"mid","C"
2559,26,13,13,15087.002850178,"mid","C"
2560,68,29,39,45987.1568054521,"mid","C"
2561,7,2,5,4608.86421924648,"small","C"
2562,112,29,83,155488.32713454,"big","C"
2563,90,45,45,65437.8437758171,"mid","C"
2564,16,3,13,14815.6503292297,"mid","C"
2565,16,9,7,4550.89047477393,"mid","C"
2566,109,1,108,172494.600041837,"big","C"
2567,46,2,44,28641.6738783415,"mid","C"
2568,49,11,38,78308.0249082626,"mid","C"
2569,20,18,2,36906.0374529219,"mid","C"
2570,99,41,58,331901.572585895,"mid","C"
2571,53,9,44,145784.01813417,"mid","C"
2572,204,93,111,47354.1917505052,"big","C"
2573,41,36,5,39756.6316207022,"mid","C"
2574,130,32,98,103132.287973529,"big","C"
2575,38,2,36,68804.5024994561,"mid","C"
2576,27,8,19,34780.4909992332,"mid","C"
2577,96,8,88,21330.5570663943,"mid","C"
2578,96,4,92,34136.7076323826,"mid","C"
2579,61,34,27,104487.889025219,"mid","C"
2580,42,4,38,93359.1138325849,"mid","C"
2581,38,15,23,5757.74271072724,"mid","C"
2582,25,5,20,57031.620168132,"mid","C"
2583,245,20,225,525482.121052079,"big","C"
2584,87,74,13,17774.0435637198,"mid","C"
2585,48,16,32,32664.9317041236,"mid","C"
2586,114,83,31,3945.41577377597,"big","C"
2587,188,6,182,154159.258024335,"big","C"
2588,34,17,17,41804.999434675,"mid","C"
2589,53,28,25,65294.6354820762,"mid","C"
2590,35,19,16,25323.1595758438,"mid","C"
2591,105,48,57,111151.472974685,"big","C"
2592,3,3,0,2652.15608337039,"small","C"
2593,8,3,5,5842.65243700664,"small","C"
2594,82,47,35,105068.520433362,"mid","C"
2595,11,1,10,3499.37270160334,"mid","C"
2596,40,33,7,40200.9784181667,"mid","C"
2597,4,1,3,3004.65988316285,"small","C"
2598,9,4,5,3399.02338187853,"small","C"
2599,48,46,2,42160.5733945294,"mid","C"
2600,118,43,75,310113.214678493,"big","C"
2601,24,6,18,41455.5883134484,"mid","C"
2602,102,23,79,12238.6443460211,"big","C"
2603,56,4,52,19076.4878274267,"mid","C"
2604,8,2,6,2365.03594571857,"small","C"
2605,149,133,16,56690.6071602561,"big","C"
2606,72,43,29,208526.533091926,"mid","C"
2607,176,92,84,168102.668369724,"big","C"
2608,186,6,180,414604.1347995,"big","C"
2609,11,3,8,14784.5841413789,"mid","C"
2610,16,14,2,9060.86300076783,"mid","C"
2611,118,66,52,14948.6983074739,"big","C"
2612,12,10,2,2374.21604181541,"mid","C"
2613,32,8,24,8208.80539272765,"mid","C"
2614,100,3,97,70871.4884968106,"mid","C"
2615,47,36,11,34378.8733187367,"mid","C"
2616,87,50,37,88770.7049530415,"mid","C"
2617,2,0,2,653.014497693788,"small","C"
2618,126,82,44,23412.8776568431,"big","C"
2619,88,58,30,122229.794089902,"mid","C"
2620,145,137,8,53009.9542880639,"big","C"
2621,123,102,21,249108.952768138,"big","C"
2622,29,18,11,8905.15322779315,"mid","C"
2623,125,116,9,161539.618345102,"big","C"
2624,10,2,8,16764.1838520491,"small","C"
2625,95,26,69,11805.7312015375,"mid","C"
2626,171,52,119,132886.213755199,"big","C"
2627,13,8,5,279.887973935642,"mid","C"
2628,49,41,8,6545.64986782238,"mid","C"
2629,19,8,11,13305.7395301254,"mid","C"
2630,96,22,74,111900.831247995,"mid","C"
2631,69,43,26,159831.12377929,"mid","C"
2632,105,42,63,37203.0804760835,"big","C"
2633,28,23,5,33950.5030940326,"mid","C"
2634,14,4,10,2029.14394003229,"mid","C"
2635,24,9,15,8066.81254971345,"mid","C"
2636,86,38,48,151324.008990023,"mid","C"
2637,64,60,4,186864.250889676,"mid","C"
2638,109,94,15,87687.5566203521,"big","C"
2639,113,11,102,74184.6178177823,"big","C"
2640,141,115,26,166021.21582885,"big","C"
2641,110,42,68,271476.188221335,"big","C"
2642,35,22,13,114442.16260078,"mid","C"
2643,24,2,22,39168.6234650615,"mid","C"
2644,111,13,98,44517.6351688291,"big","C"
2645,11,5,6,16561.1512285854,"mid","C"
2646,46,32,14,74562.2542578766,"mid","C"
2647,35,11,24,5872.94873871319,"mid","C"
2648,51,7,44,103361.651749114,"mid","C"
2649,15,5,10,31206.7136850876,"mid","C"
2650,177,94,83,170862.505532379,"big","C"
2651,139,56,83,174875.302020518,"big","C"
2652,12,0,12,16745.4099115311,"mid","C"
2653,90,42,48,67551.0353292635,"mid","C"
2654,139,61,78,374332.182218452,"big","C"
2655,110,60,50,215368.267853273,"big","C"
2656,1,0,1,1221.74403362988,"small","C"
2657,53,30,23,5645.51038221216,"mid","C"
2658,18,15,3,25892.2152913962,"mid","C"
2659,1,1,0,1198.97013054848,"small","C"
2660,130,111,19,257894.704477152,"big","C"
2661,8,4,4,12889.8025327971,"small","C"
2662,81,62,19,194280.464433095,"mid","C"
2663,29,27,2,9493.46590288523,"mid","C"
2664,111,94,17,259033.498970687,"big","C"
2665,26,19,7,9182.0518425126,"mid","C"
2666,162,7,155,286663.432715633,"big","C"
2667,104,88,16,66067.0220126632,"big","C"
2668,96,18,78,46641.2264037514,"mid","C"
2669,44,28,16,39264.5261572075,"mid","C"
2670,23,22,1,59464.2852413423,"mid","C"
2671,9,0,9,5689.93307993353,"small","C"
2672,67,1,66,215879.65238916,"mid","C"
2673,226,56,170,57993.5998502906,"big","C"
2674,47,33,14,5873.86018489533,"mid","C"
2675,63,45,18,66440.5795011566,"mid","C"
2676,4,4,0,260.705096107316,"small","C"
2677,132,22,110,19834.2134101359,"big","C"
2678,110,83,27,78400.0651290666,"big","C"
2679,118,51,67,266780.591849937,"big","C"
2680,245,45,200,318022.373441817,"big","C"
2681,27,5,22,17497.6483021828,"mid","C"
2682,30,23,7,18816.5118952978,"mid","C"
2683,39,13,26,60089.7490330857,"mid","C"
2684,182,71,111,129178.3057668,"big","C"
2685,93,79,14,130713.105114327,"mid","C"
2686,106,53,53,224306.416308005,"big","C"
2687,31,12,19,78265.933294272,"mid","C"
2688,111,28,83,39124.6613949971,"big","C"
2689,55,0,55,83328.3332627125,"mid","C"
2690,45,6,39,1066.16047910864,"mid","C"
2691,20,9,11,9489.58685496389,"mid","C"
2692,46,29,17,22664.3769571521,"mid","C"
2693,174,18,156,227132.065050667,"big","C"
2694,106,85,21,218510.250224393,"big","C"
2695,8,4,4,12325.5561956345,"small","C"
2696,9,6,3,7997.92738722795,"small","C"
2697,56,19,37,94653.1244679967,"mid","C"
2698,20,9,11,37366.2702504346,"mid","C"
2699,54,45,9,64532.985209403,"mid","C"
2700,38,5,33,24284.8320997891,"mid","C"
2701,92,64,28,59963.1625914434,"mid","C"
2702,11,9,2,20453.0057009231,"mid","C"
2703,56,10,46,117057.19019627,"mid","C"
2704,144,110,34,236029.426595334,"big","C"
2705,58,39,19,42209.3479051945,"mid","C"
2706,5,0,5,4449.52298959641,"small","C"
2707,48,46,2,61968.4678465831,"mid","C"
2708,79,17,62,94106.0728118041,"mid","C"
2709,57,28,29,86510.6435969632,"mid","C"
2710,106,32,74,233021.853987194,"big","C"
2711,276,44,232,469952.51901259,"big","C"
2712,33,29,4,33178.4089624549,"mid","C"
2713,188,125,63,560879.784307737,"big","C"
2714,63,32,31,91120.2187187437,"mid","C"
2715,24,23,1,76455.9111776692,"mid","C"
2716,130,119,11,242400.413104582,"big","C"
2717,135,69,66,15305.1945179899,"big","C"
2718,155,137,18,177271.563563774,"big","C"
2719,43,9,34,11310.5894574762,"mid","C"
2720,60,37,23,39539.0697540148,"mid","C"
2721,51,43,8,91327.1333324913,"mid","C"
2722,12,4,8,1425.77216314097,"mid","C"
2723,80,76,4,197823.399951752,"mid","C"
2724,40,25,15,121342.716994245,"mid","C"
2725,64,21,43,8716.66589594683,"mid","C"
2726,91,40,51,167409.245342313,"mid","C"
2727,213,63,150,537837.639898537,"big","C"
2728,152,119,33,154843.908621924,"big","C"
2729,34,24,10,40808.2561735739,"mid","C"
2730,184,26,158,116978.862545805,"big","C"
2731,106,44,62,56093.7837571872,"big","C"
2732,23,14,9,21136.6257815404,"mid","C"
2733,42,34,8,110472.308277194,"mid","C"
2734,18,0,18,36657.6689248573,"mid","C"
2735,43,7,36,36080.6247551333,"mid","C"
2736,173,129,44,23516.345286088,"big","C"
2737,8,7,1,9541.63041885164,"small","C"
2738,5,2,3,5429.79346142496,"small","C"
2739,92,90,2,99741.4435897834,"mid","C"
2740,16,13,3,6292.16832126399,"mid","C"
2741,17,10,7,1348.12996696006,"mid","C"
2742,150,34,116,89501.2349766844,"big","C"
2743,153,40,113,317732.64354555,"big","C"
2744,112,17,95,15854.2049108816,"big","C"
2745,29,23,6,6504.8392600039,"mid","C"
2746,39,22,17,22036.0894696957,"mid","C"
2747,126,47,79,45148.6398980281,"big","C"
2748,175,31,144,198590.554368504,"big","C"
2749,18,17,1,7016.92082754472,"mid","C"
2750,157,2,155,169709.643161923,"big","C"
2751,12,10,2,9096.98627909023,"mid","C"
2752,143,97,46,221826.181580555,"big","C"
2753,150,57,93,219576.712359619,"big","C"
2754,56,19,37,35916.2647286809,"mid","C"
2755,30,9,21,20936.9096814995,"mid","C"
2756,88,73,15,26261.7251015126,"mid","C"
2757,103,49,54,174979.69138872,"big","C"
2758,102,55,47,194416.675728935,"big","C"
2759,73,57,16,132904.029103131,"mid","C"
2760,270,40,230,102409.946718188,"big","C"
2761,38,7,31,60685.9858661817,"mid","C"
2762,2,2,0,95.0923267789435,"small","C"
2763,234,15,219,353272.303132747,"big","C"
2764,59,45,14,69057.4243208244,"mid","C"
2765,36,10,26,21964.8119219264,"mid","C"
2766,60,36,24,66796.3587039158,"mid","C"
2767,16,5,11,22859.1760951739,"mid","C"
2768,44,12,32,68493.2959769987,"mid","C"
2769,177,34,143,101841.24387279,"big","C"
2770,106,39,67,400704.317604467,"big","C"
2771,137,41,96,122426.230531932,"big","C"
2772,1,0,1,2658.12525553774,"small","C"
2773,33,19,14,2051.27634262733,"mid","C"
2774,66,33,33,25491.967149987,"mid","C"
2775,59,23,36,33603.8372122876,"mid","C"
2776,12,8,4,13604.9074715153,"mid","C"
2777,28,10,18,26944.325567749,"mid","C"
2778,21,21,0,35707.5772526083,"mid","C"
2779,45,1,44,59024.9543062517,"mid","C"
2780,83,46,37,143639.497208262,"mid","C"
2781,3,2,1,2924.93857896247,"small","C"
2782,33,30,3,71636.909393835,"mid","C"
2783,83,22,61,195998.624992948,"mid","C"
2784,186,28,158,620212.115190326,"big","C"
2785,119,92,27,28437.1339371269,"big","C"
2786,57,57,0,61308.6946135458,"mid","C"
2787,61,15,46,46411.6319091583,"mid","C"
2788,3,1,2,7525.63048202477,"small","C"
2789,59,18,41,126281.268491561,"mid","C"
2790,140,14,126,34276.3059920025,"big","C"
2791,40,31,9,63202.3362639309,"mid","C"
2792,28,15,13,31015.4822442271,"mid","C"
2793,96,40,56,195486.401300207,"mid","C"
2794,28,25,3,64852.787948028,"mid","C"
2795,18,12,6,16718.0830388863,"mid","C"
2796,115,85,30,226339.108310281,"big","C"
2797,63,13,50,39285.410088071,"mid","C"
2798,131,129,2,70660.5782043968,"big","C"
2799,139,59,80,118015.308231606,"big","C"
2800,115,10,105,98979.1522605639,"big","C"
2801,29,6,23,10587.1566944102,"mid","C"
2802,104,24,80,200110.582912177,"big","C"
2803,80,34,46,41921.1282666855,"mid","C"
2804,249,50,199,803857.325849286,"big","C"
2805,71,55,16,104865.493115225,"mid","C"
2806,57,6,51,91175.7340024473,"mid","C"
2807,40,22,18,17038.1595520703,"mid","C"
2808,37,37,0,54665.9163522242,"mid","C"
2809,70,35,35,26803.8673924587,"mid","C"
2810,25,20,5,32130.798062848,"mid","C"
2811,2,1,1,2668.12408408647,"small","C"
2812,19,18,1,33571.1096681396,"mid","C"
2813,284,195,89,9604.52559222499,"big","C"
2814,70,27,43,251853.403925132,"mid","C"
2815,95,1,94,244654.00118185,"mid","C"
2816,14,4,10,5879.55310074485,"mid","C"
2817,7,3,4,15837.2294487295,"small","C"
2818,138,120,18,125266.722761841,"big","C"
2819,127,46,81,330737.586880592,"big","C"
2820,47,12,35,67088.9039238482,"mid","C"
2821,93,28,65,75687.3407181556,"mid","C"
2822,24,3,21,60400.2618345179,"mid","C"
2823,52,5,47,108499.17340757,"mid","C"
2824,249,81,168,266808.820081063,"big","C"
2825,161,55,106,183783.722617014,"big","C"
2826,204,197,7,336711.390688693,"big","C"
2827,101,54,47,177214.868102922,"big","C"
2828,118,72,46,122433.687592461,"big","C"
2829,146,5,141,111956.595915809,"big","C"
2830,54,24,30,172224.679427064,"mid","C"
2831,4,0,4,6659.35046840801,"small","C"
2832,49,41,8,98766.0386141745,"mid","C"
2833,3,1,2,2702.0576691155,"small","C"
2834,37,20,17,105053.014395938,"mid","C"
2835,171,61,110,383686.223715389,"big","C"
2836,16,16,0,4754.84654193256,"mid","C"
2837,116,9,107,75363.2912448135,"big","C"
2838,109,98,11,268381.621700594,"big","C"
2839,75,42,33,87853.6615449366,"mid","C"
2840,28,5,23,67149.6088711001,"mid","C"
2841,109,18,91,18786.9840061978,"big","C"
2842,100,23,77,53738.7192967524,"mid","C"
2843,220,162,58,188248.886985451,"big","C"
2844,34,12,22,7988.93905454287,"mid","C"
2845,12,6,6,14779.57809878,"mid","C"
2846,5,4,1,14931.4129054993,"small","C"
2847,15,9,6,4575.37368730427,"mid","C"
2848,11,10,1,31720.4310053932,"mid","C"
2849,156,101,55,117203.54076168,"big","C"
2850,251,185,66,248397.549153458,"big","C"
2851,57,28,29,93165.861264859,"mid","C"
2852,17,11,6,13647.714354086,"mid","C"
2853,95,19,76,4750.20834679018,"mid","C"
2854,111,60,51,50209.3413458302,"big","C"
2855,131,18,113,131886.25490199,"big","C"
2856,20,16,4,14712.8281374271,"mid","C"
2857,180,19,161,181148.449501181,"big","C"
2858,3,2,1,3572.96111727612,"small","C"
2859,18,7,11,18323.6248604926,"mid","C"
2860,76,13,63,89028.8605619577,"mid","C"
2861,342,331,11,551079.184412665,"big","C"
2862,26,4,22,8564.47823163501,"mid","C"
2863,135,83,52,25704.2979949296,"big","C"
2864,50,28,22,42154.3041498869,"mid","C"
2865,173,113,60,449555.441698746,"big","C"
2866,5,3,2,364.337990599305,"small","C"
2867,22,16,6,15072.1736017946,"mid","C"
2868,79,53,26,85838.449569241,"mid","C"
2869,158,13,145,28489.4990697336,"big","C"
2870,44,11,33,43585.0880470303,"mid","C"
2871,49,3,46,56784.5019529101,"mid","C"
2872,64,12,52,24157.2337098742,"mid","C"
2873,22,4,18,10360.096580036,"mid","C"
2874,139,134,5,249796.879036232,"big","C"
2875,93,47,46,37177.4768611083,"mid","C"
2876,83,26,57,19279.3306066118,"mid","C"
2877,150,123,27,342.101965684003,"big","C"
2878,42,32,10,18838.846335588,"mid","C"
2879,50,21,29,31570.9061386193,"mid","C"
2880,122,72,50,81162.5709601423,"big","C"
2881,3,2,1,4658.56195056836,"small","C"
2882,3,2,1,4881.99234850972,"small","C"
2883,37,18,19,50910.4025727458,"mid","C"
2884,61,35,26,48512.8631739688,"mid","C"
2885,66,39,27,70478.3481157992,"mid","C"
2886,146,42,104,236165.078920106,"big","C"
2887,123,111,12,256452.74582055,"big","C"
2888,133,77,56,290678.904357532,"big","C"
2889,119,56,63,326615.340664427,"big","C"
2890,19,14,5,45013.1152936827,"mid","C"
2891,24,20,4,40001.7592312061,"mid","C"
2892,50,8,42,67448.8352666811,"mid","C"
2893,26,3,23,7304.00029424123,"mid","C"
2894,27,7,20,24720.8536157904,"mid","C"
2895,212,10,202,31076.2714485738,"big","C"
2896,126,116,10,45412.5549585404,"big","C"
2897,27,5,22,48888.209630387,"mid","C"
2898,3,2,1,1236.32420322448,"small","C"
2899,46,23,23,2616.08360077964,"mid","C"
2900,91,70,21,258481.328271692,"mid","C"
2901,123,63,60,40263.2836513321,"big","C"
2902,95,29,66,204921.379502207,"mid","C"
2903,120,11,109,181906.978739943,"big","C"
2904,100,43,57,195006.707302466,"mid","C"
2905,88,28,60,82954.6914829522,"mid","C"
2906,37,31,6,10932.5828560421,"mid","C"
2907,34,1,33,52969.3543913304,"mid","C"
2908,34,8,26,52856.0948374605,"mid","C"
2909,83,47,36,64756.4911354574,"mid","C"
2910,95,70,25,226953.020228472,"mid","C"
2911,65,35,30,1587.95900730579,"mid","C"
2912,5,2,3,9377.95078738806,"small","C"
2913,4,2,2,5975.82669966577,"small","C"
2914,161,6,155,154805.267723788,"big","C"
2915,109,64,45,564.110386878364,"big","C"
2916,6,2,4,2325.97364681046,"small","C"
2917,75,22,53,17635.9895890289,"mid","C"
2918,70,19,51,36469.7947776143,"mid","C"
2919,213,95,118,140594.586133045,"big","C"
2920,122,100,22,246449.801399846,"big","C"
2921,68,30,38,2073.2455728985,"mid","C"
2922,40,10,30,62357.6986802508,"mid","C"
2923,163,34,129,299910.224622098,"big","C"
2924,107,59,48,247109.687682484,"big","C"
2925,242,235,7,139770.479629143,"big","C"
2926,60,3,57,42107.4330053253,"mid","C"
2927,60,35,25,43179.6635553563,"mid","C"
2928,76,72,4,10411.0856055657,"mid","C"
2929,106,54,52,185079.426878477,"big","C"
2930,124,61,63,390886.810564985,"big","C"
2931,51,34,17,51804.1798123511,"mid","C"
2932,48,8,40,83002.7509620452,"mid","C"
2933,22,4,18,52709.6813272711,"mid","C"
2934,1,1,0,3110.53258306402,"small","C"
2935,53,26,27,114009.536748291,"mid","C"
2936,189,179,10,218731.987656416,"big","C"
2937,62,52,10,57829.548369691,"mid","C"
2938,15,13,2,8092.12786317343,"mid","C"
2939,4,3,1,5406.01689795119,"small","C"
2940,159,74,85,54859.7287996832,"big","C"
2941,74,58,16,31575.66490239,"mid","C"
2942,186,124,62,216463.469648154,"big","C"
2943,68,21,47,7135.38346534291,"mid","C"
2944,121,61,60,137426.882321428,"big","C"
2945,11,8,3,12464.1245109865,"mid","C"
2946,103,6,97,226797.342474513,"big","C"
2947,59,4,55,55932.8368218314,"mid","C"
2948,45,12,33,10133.2874528336,"mid","C"
2949,97,96,1,167773.754730516,"mid","C"
2950,113,13,100,20027.9536390085,"big","C"
2951,250,93,157,412123.405667254,"big","C"
2952,62,25,37,85002.7709827837,"mid","C"
2953,32,13,19,81984.7564175012,"mid","C"
2954,116,79,37,175281.705009122,"big","C"
2955,87,51,36,139878.027069526,"mid","C"
2956,203,28,175,239050.801193958,"big","C"
2957,19,10,9,3238.23288807449,"mid","C"
2958,139,99,40,229584.009309751,"big","C"
2959,52,13,39,28254.4584516144,"mid","C"
2960,97,29,68,176161.57782788,"mid","C"
2961,132,82,50,232352.913304754,"big","C"
2962,72,9,63,132913.957199051,"mid","C"
2963,26,12,14,29887.9527417404,"mid","C"
2964,36,25,11,5940.46688077938,"mid","C"
2965,81,45,36,78953.2071439479,"mid","C"
2966,18,4,14,27577.0350736623,"mid","C"
2967,31,8,23,33697.4419466655,"mid","C"
2968,6,2,4,1308.29814592087,"small","C"
2969,41,25,16,85049.3065358844,"mid","C"
2970,53,6,47,41438.8979871645,"mid","C"
2971,10,8,2,12974.4516679045,"small","C"
2972,8,3,5,7506.21403394404,"small","C"
2973,9,9,0,10321.0346026617,"small","C"
2974,104,93,11,127664.638581939,"big","C"
2975,113,16,97,17429.5608420101,"big","C"
2976,309,207,102,47379.7728941693,"big","C"
2977,39,13,26,12743.8291475825,"mid","C"
2978,31,29,2,14251.5324369695,"mid","C"
2979,158,35,123,411822.616674251,"big","C"
2980,107,23,84,132165.464110713,"big","C"
2981,85,12,73,11430.0200763044,"mid","C"
2982,45,9,36,43907.7444824381,"mid","C"
2983,38,34,4,25807.1830725764,"mid","C"
2984,120,23,97,239079.333487415,"big","C"
2985,147,75,72,235237.422762736,"big","C"
2986,51,1,50,1475.94972232061,"mid","C"
2987,23,18,5,20786.0775066969,"mid","C"
2988,75,6,69,69513.4773395872,"mid","C"
2989,100,74,26,23514.6845060609,"mid","C"
2990,138,91,47,182413.98181262,"big","C"
2991,54,20,34,17240.6307295489,"mid","C"
2992,67,32,35,93550.482810767,"mid","C"
2993,114,52,62,6791.63115161132,"big","C"
2994,131,27,104,161331.738164533,"big","C"
2995,17,14,3,46470.0408311681,"mid","C"
2996,128,63,65,181727.038993368,"big","C"
2997,27,23,4,2297.14852623009,"mid","C"
2998,171,31,140,98576.404419485,"big","C"
2999,199,194,5,384496.420170585,"big","C"
3000,113,17,96,103826.608139996,"big","C"
3001,28,21,7,17386.9848484673,"mid","C"
3002,56,53,3,69366.056499158,"mid","C"
3003,63,9,54,20329.6463843245,"mid","C"
3004,56,55,1,4060.05713376158,"mid","C"
3005,135,80,55,154487.723827011,"big","C"
3006,142,19,123,134295.92794129,"big","C"
3007,11,8,3,3714.82173329769,"mid","C"
3008,63,32,31,31138.4959888305,"mid","C"
3009,57,31,26,42065.5022140635,"mid","C"
3010,37,32,5,55115.3198373562,"mid","C"
3011,48,18,30,131369.012460798,"mid","C"
3012,41,1,40,40848.1122765215,"mid","C"
3013,63,3,60,97809.3932654699,"mid","C"
3014,71,53,18,84944.6115359023,"mid","C"
3015,46,32,14,2818.71041126673,"mid","C"
3016,51,47,4,5471.76605532439,"mid","C"
3017,105,49,56,87194.3595422137,"big","C"
3018,222,191,31,49303.4030251572,"big","C"
3019,109,46,63,149915.04690874,"big","C"
3020,87,5,82,140354.368735871,"mid","C"
3021,5,4,1,9581.72427085429,"small","C"
3022,135,130,5,169463.109416672,"big","C"
3023,132,75,57,188364.107378143,"big","C"
3024,163,104,59,120090.918272015,"big","C"
3025,119,14,105,53212.5846088296,"big","C"
3026,104,59,45,135377.756068862,"big","C"
3027,55,31,24,68895.6257704912,"mid","C"
3028,53,18,35,74914.8975468731,"mid","C"
3029,112,5,107,86507.3952120708,"big","C"
3030,48,39,9,104692.73767777,"mid","C"
3031,96,7,89,182924.981161778,"mid","C"
3032,76,74,2,71563.2714674723,"mid","C"
3033,71,59,12,2865.63774872969,"mid","C"
3034,13,6,7,18819.0142046671,"mid","C"
3035,54,48,6,53281.2165410252,"mid","C"
3036,46,7,39,17725.3517424823,"mid","C"
3037,191,7,184,312356.283394177,"big","C"
3038,83,13,70,300128.793227542,"mid","C"
3039,73,34,39,6999.14523908132,"mid","C"
3040,19,7,12,1022.80128523435,"mid","C"
3041,218,54,164,324006.254657726,"big","C"
3042,9,1,8,8267.25234610192,"small","C"
3043,11,3,8,8077.645438572,"mid","C"
3044,185,100,85,157567.488573777,"big","C"
3045,128,85,43,43874.3387115084,"big","C"
3046,90,65,25,49829.8912590813,"mid","C"
3047,35,8,27,41616.2149185149,"mid","C"
3048,60,50,10,60292.2057561818,"mid","C"
3049,111,77,34,143748.215548546,"big","C"
3050,131,119,12,24901.6892896043,"big","C"
3051,17,13,4,6744.46415145361,"mid","C"
3052,80,41,39,5377.66594035767,"mid","C"
3053,151,49,102,11947.9008743263,"big","C"
3054,37,3,34,24342.9785144608,"mid","C"
3055,26,20,6,31930.5541962111,"mid","C"
3056,8,0,8,10503.0464870752,"small","C"
3057,28,11,17,2274.23118340197,"mid","C"
3058,107,49,58,59699.6059527444,"big","C"
3059,15,11,4,39309.3541312477,"mid","C"
3060,34,1,33,38115.1024519933,"mid","C"
3061,122,73,49,153396.047417003,"big","C"
3062,87,81,6,71918.4088460279,"mid","C"
3063,115,84,31,282649.507145536,"big","C"
3064,101,39,62,213604.649133091,"big","C"
3065,273,100,173,218618.919231051,"big","C"
3066,13,7,6,9227.54063106799,"mid","C"
3067,57,8,49,156388.849814435,"mid","C"
3068,45,31,14,88148.9171927883,"mid","C"
3069,129,107,22,278923.748406183,"big","C"
3070,146,90,56,269662.049898903,"big","C"
3071,140,16,124,313159.989678674,"big","C"
3072,144,18,126,180729.467316105,"big","C"
3073,2,1,1,158.036775502805,"small","C"
3074,222,174,48,326715.729908636,"big","C"
3075,29,18,11,1421.97857446654,"mid","C"
3076,16,11,5,9194.39668332198,"mid","C"
3077,105,81,24,179342.195595958,"big","C"
3078,159,134,25,16305.4112341965,"big","C"
3079,78,13,65,40367.1102758954,"mid","C"
3080,2,1,1,2912.59807676575,"small","C"
3081,42,15,27,10818.1226427121,"mid","C"
3082,203,85,118,551125.474682001,"big","C"
3083,83,13,70,12845.8703621571,"mid","C"
3084,144,20,124,263771.869979521,"big","C"
3085,108,44,64,116851.422352614,"big","C"
3086,3,3,0,8176.83196480806,"small","C"
3087,66,50,16,107616.064976251,"mid","C"
3088,53,14,39,127168.850860508,"mid","C"
3089,150,120,30,180551.538270245,"big","C"
3090,102,64,38,132337.026948897,"big","C"
3091,79,77,2,72154.615577712,"mid","C"
3092,25,0,25,40035.8569288899,"mid","C"
3093,51,41,10,85631.7018568052,"mid","C"
3094,25,1,24,27283.3807419065,"mid","C"
3095,79,8,71,131422.462927611,"mid","C"
3096,148,32,116,154230.915604122,"big","C"
3097,14,5,9,10352.7244793719,"mid","C"
3098,26,24,2,58698.1535485513,"mid","C"
3099,13,9,4,6310.35161664163,"mid","C"
3100,110,46,64,15111.9421828611,"big","C"
3101,69,13,56,253907.960522969,"mid","C"
3102,85,58,27,176897.740933742,"mid","C"
3103,167,146,21,423031.348459415,"big","C"
3104,184,95,89,224430.661965644,"big","C"
3105,62,7,55,88312.8043694493,"mid","C"
3106,21,3,18,17723.6086126219,"mid","C"
3107,157,30,127,381435.264526543,"big","C"
3108,117,109,8,80320.8949084685,"big","C"
3109,69,10,59,130024.121707201,"mid","C"
3110,113,46,67,323167.188979554,"big","C"
3111,31,4,27,29229.8219879168,"mid","C"
3112,24,17,7,36191.2017180624,"mid","C"
3113,6,6,0,20025.8132914053,"small","C"
3114,44,6,38,37925.242921819,"mid","C"
3115,18,16,2,27287.5207981841,"mid","C"
3116,80,44,36,69097.6071492621,"mid","C"
3117,146,47,99,69757.2985682908,"big","C"
3118,82,69,13,108229.906561727,"mid","C"
3119,169,124,45,80242.8252874335,"big","C"
3120,5,4,1,7387.27728802785,"small","C"
3121,67,18,49,35512.1499244877,"mid","C"
3122,60,23,37,72772.6842226334,"mid","C"
3123,8,7,1,13478.6813730879,"small","C"
3124,6,0,6,18134.9914886988,"small","C"
3125,21,8,13,37073.6443840782,"mid","C"
3126,57,30,27,157275.012188294,"mid","C"
3127,17,16,1,18245.3839049329,"mid","C"
3128,17,0,17,27201.2758750096,"mid","C"
3129,52,33,19,210746.397432981,"mid","C"
3130,79,70,9,119731.624316249,"mid","C"
3131,51,26,25,33351.1773624093,"mid","C"
3132,200,146,54,195710.401911129,"big","C"
3133,73,8,65,142448.392899774,"mid","C"
3134,267,51,216,262865.767106814,"big","C"
3135,46,1,45,88188.6789083949,"mid","C"
3136,106,0,106,11214.6009284255,"big","C"
3137,152,37,115,85651.9597354453,"big","C"
3138,82,6,76,179543.198449169,"mid","C"
3139,2,2,0,914.545815429994,"small","C"
3140,229,67,162,180852.760767157,"big","C"
3141,85,44,41,24150.2459156286,"mid","C"
3142,134,108,26,180606.765313978,"big","C"
3143,247,239,8,250537.737022019,"big","C"
3144,105,45,60,11012.5251356192,"big","C"
3145,18,15,3,6111.53457555453,"mid","C"
3146,22,12,10,11829.2361823752,"mid","C"
3147,85,64,21,137145.326834523,"mid","C"
3148,43,29,14,50002.5915014062,"mid","C"
3149,50,38,12,3106.88582093611,"mid","C"
3150,36,9,27,44798.6881128319,"mid","C"
3151,84,11,73,72439.5674061496,"mid","C"
3152,199,151,48,22409.6014233995,"big","C"
3153,83,72,11,193333.786297234,"mid","C"
3154,37,3,34,28345.8655142742,"mid","C"
3155,21,17,4,52549.9121350983,"mid","C"
3156,65,39,26,24597.9033937749,"mid","C"
3157,187,3,184,153637.013953958,"big","C"
3158,29,7,22,62301.1676005797,"mid","C"
3159,36,4,32,44160.2895992362,"mid","C"
3160,75,57,18,180290.360358761,"mid","C"
3161,83,38,45,52933.69103938,"mid","C"
3162,119,7,112,135309.918032855,"big","C"
3163,118,51,67,259100.808381522,"big","C"
3164,169,161,8,80500.957912776,"big","C"
3165,56,25,31,2373.03527952175,"mid","C"
3166,42,16,26,44722.5150188204,"mid","C"
3167,39,33,6,81937.142924702,"mid","C"
3168,77,30,47,224607.296494184,"mid","C"
3169,224,109,115,439421.895071183,"big","C"
3170,5,0,5,10619.6113561919,"small","C"
3171,48,33,15,88669.6393823315,"mid","C"
3172,47,29,18,66668.6866971815,"mid","C"
3173,93,59,34,104980.14828776,"mid","C"
3174,2,2,0,5171.92519539146,"small","C"
3175,6,2,4,13140.0269395587,"small","C"
3176,87,61,26,102845.448543689,"mid","C"
3177,178,26,152,99299.0684923884,"big","C"
3178,33,16,17,68535.5146151391,"mid","C"
3179,193,90,103,508166.972385403,"big","C"
3180,44,33,11,76354.9515800439,"mid","C"
3181,53,12,41,85249.4833465017,"mid","C"
3182,9,8,1,9443.8888633139,"small","C"
3183,107,15,92,84163.4327565385,"big","C"
3184,75,75,0,81025.526342479,"mid","C"
3185,160,82,78,31889.8971058902,"big","C"
3186,133,74,59,90963.7073904074,"big","C"
3187,19,18,1,470.546854709258,"mid","C"
3188,61,36,25,62993.29642636,"mid","C"
3189,51,24,27,29230.9970175057,"mid","C"
3190,27,7,20,22383.2130887208,"mid","C"
3191,1,1,0,1237.64533498187,"small","C"
3192,79,68,11,75446.1286597184,"mid","C"
3193,219,202,17,158627.371040483,"big","C"
3194,224,12,212,105757.574648574,"big","C"
3195,18,3,15,34086.4760804015,"mid","C"
3196,11,10,1,14999.0451662274,"mid","C"
3197,71,2,69,39519.4140624183,"mid","C"
3198,61,58,3,52431.9108151752,"mid","C"
3199,252,92,160,82503.3032287398,"big","C"
3200,16,14,2,22100.9067559174,"mid","C"
3201,8,4,4,5697.55468833223,"small","C"
3202,15,2,13,3026.67669281457,"mid","C"
3203,101,21,80,45915.9193855163,"big","C"
3204,68,43,25,132655.459316477,"mid","C"
3205,262,184,78,289486.872708102,"big","C"
3206,194,120,74,366198.885480847,"big","C"
3207,30,29,1,44196.9359049688,"mid","C"
3208,4,1,3,7629.38720241771,"small","C"
3209,3,0,3,1086.37924679163,"small","C"
3210,35,2,33,68774.2549486961,"mid","C"
3211,149,24,125,25807.8420487748,"big","C"
3212,81,50,31,87276.1315296876,"mid","C"
3213,48,43,5,41047.2760814978,"mid","C"
3214,16,5,11,7835.93836991878,"mid","C"
3215,23,16,7,24146.7866675236,"mid","C"
3216,57,10,47,14959.548736969,"mid","C"
3217,110,91,19,11189.9625736759,"big","C"
3218,157,69,88,170269.665127862,"big","C"
3219,154,63,91,92997.2048715712,"big","C"
3220,53,44,9,2418.96468277238,"mid","C"
3221,57,54,3,27783.2990525558,"mid","C"
3222,132,8,124,113630.561904898,"big","C"
3223,231,11,220,417174.23371741,"big","C"
3224,142,61,81,92498.974243575,"big","C"
3225,127,74,53,203019.868950847,"big","C"
3226,4,0,4,5307.26226417899,"small","C"
3227,46,15,31,30106.3363047497,"mid","C"
3228,53,44,9,7065.80546649762,"mid","C"
3229,28,7,21,35936.7653508344,"mid","C"
3230,4,2,2,7585.4809546161,"small","C"
3231,115,30,85,162689.335198964,"big","C"
3232,176,47,129,195503.876635865,"big","C"
3233,157,46,111,8595.31076184405,"big","C"
3234,18,6,12,2389.77945630898,"mid","C"
3235,301,105,196,111382.256083313,"big","C"
3236,45,16,29,753.620609818512,"mid","C"
3237,35,28,7,78725.7203744312,"mid","C"
3238,9,7,2,10619.9986305782,"small","C"
3239,16,1,15,13704.3964930926,"mid","C"
3240,10,8,2,6600.45662864005,"small","C"
3241,151,129,22,263535.187898989,"big","C"
3242,164,102,62,439177.992016288,"big","C"
3243,58,7,51,61844.8249446068,"mid","C"
3244,68,49,19,3119.76692225133,"mid","C"
3245,120,97,23,264010.953515027,"big","C"
3246,96,9,87,162916.994451526,"mid","C"
3247,180,168,12,138289.106163184,"big","C"
3248,177,142,35,33724.5521618733,"big","C"
3249,268,144,124,511630.833197365,"big","C"
3250,52,43,9,71131.3563377563,"mid","C"
3251,31,4,27,35880.9788034165,"mid","C"
3252,120,44,76,261724.898215255,"big","C"
3253,15,9,6,15611.4834871871,"mid","C"
3254,277,66,211,353407.788447128,"big","C"
3255,29,27,2,56657.5059408354,"mid","C"
3256,134,114,20,231575.990607992,"big","C"
3257,83,69,14,32161.4539502269,"mid","C"
3258,36,29,7,59562.8296167166,"mid","C"
3259,49,39,10,99298.093131188,"mid","C"
3260,48,21,27,79452.9722079577,"mid","C"
3261,113,55,58,175936.426197835,"big","C"
3262,121,2,119,271057.075926493,"big","C"
3263,161,68,93,63015.9666437517,"big","C"
3264,187,40,147,214947.569548456,"big","C"
3265,33,10,23,6369.32785833925,"mid","C"
3266,83,7,76,81451.343649064,"mid","C"
3267,14,8,6,5086.00625733173,"mid","C"
3268,4,1,3,2480.16476954648,"small","C"
3269,86,63,23,86874.3694972251,"mid","C"
3270,57,56,1,72740.5119650084,"mid","C"
3271,112,86,26,90948.3449077057,"big","C"
3272,181,12,169,290084.547708273,"big","C"
3273,102,20,82,247305.198246217,"big","C"
3274,78,63,15,120891.78119052,"mid","C"
3275,19,18,1,7497.70009802463,"mid","C"
3276,165,68,97,133922.079928402,"big","C"
3277,86,78,8,42682.3188134245,"mid","C"
3278,2,1,1,1652.05689265739,"small","C"
3279,99,98,1,78696.3566045189,"mid","C"
3280,34,32,2,47440.2266210341,"mid","C"
3281,169,153,16,262655.055446804,"big","C"
3282,90,25,65,137082.384046441,"mid","C"
3283,111,59,52,100014.417123855,"big","C"
3284,13,0,13,23251.4386185877,"mid","C"
3285,109,74,35,28989.7709268987,"big","C"
3286,236,36,200,397108.704850911,"big","C"
3287,40,4,36,48533.2795830327,"mid","C"
3288,1,1,0,496.935998001171,"small","C"
3289,26,12,14,31437.6951055542,"mid","C"
3290,169,145,24,121094.955986762,"big","C"
3291,19,12,7,4772.09113440308,"mid","C"
3292,168,108,60,9330.65994401448,"big","C"
3293,41,5,36,36259.6878281464,"mid","C"
3294,44,37,7,51729.369174976,"mid","C"
3295,103,4,99,118990.137741305,"big","C"
3296,55,22,33,47364.8522040917,"mid","C"
3297,114,10,104,6844.17418075984,"big","C"
3298,63,57,6,28265.1245799075,"mid","C"
3299,226,165,61,332694.211498378,"big","C"
3300,125,46,79,92777.0617248469,"big","C"
3301,137,108,29,116264.343880365,"big","C"
3302,86,33,53,91227.9600491532,"mid","C"
3303,54,22,32,97392.1983907072,"mid","C"
3304,193,28,165,263177.095828325,"big","C"
3305,41,30,11,74913.9796864515,"mid","C"
3306,73,37,36,108794.919257548,"mid","C"
3307,112,39,73,156813.395877095,"big","C"
3308,40,33,7,824.779713221346,"mid","C"
3309,110,70,40,328849.746295398,"big","C"
3310,236,99,137,259667.256522197,"big","C"
3311,61,36,25,54192.7859339087,"mid","C"
3312,48,39,9,91077.8487296518,"mid","C"
3313,211,195,16,332052.154504746,"big","C"
3314,52,27,25,132662.391920458,"mid","C"
3315,105,2,103,246545.156811389,"big","C"
3316,56,32,24,12069.3324359819,"mid","C"
3317,41,5,36,48294.8318273943,"mid","C"
3318,191,153,38,222662.606071319,"big","C"
3319,116,92,24,36606.7870518201,"big","C"
3320,45,41,4,70605.5134364391,"mid","C"
3321,144,101,43,136941.491936865,"big","C"
3322,105,95,10,298694.743838884,"big","C"
3323,2,0,2,687.647036257709,"small","C"
3324,45,21,24,124676.510319565,"mid","C"
3325,85,43,42,102725.17301627,"mid","C"
3326,35,4,31,78201.587447662,"mid","C"
3327,59,10,49,53889.1616867535,"mid","C"
3328,207,75,132,99494.5228634206,"big","C"
3329,15,6,9,35944.0716653452,"mid","C"
3330,113,22,91,108267.346400084,"big","C"
3331,119,1,118,93272.4278260263,"big","C"
3332,31,12,19,15610.1786630849,"mid","C"
3333,102,26,76,118881.213412714,"big","C"
3334,52,52,0,28073.1034197072,"mid","C"
3335,103,76,27,181878.679020128,"big","C"
3336,69,23,46,44578.6820543629,"mid","C"
3337,58,21,37,47422.0724767411,"mid","C"
3338,102,75,27,79089.7468763525,"big","C"
3339,75,31,44,7282.16774665586,"mid","C"
3340,79,31,48,123988.677596444,"mid","C"
3341,10,4,6,11759.2077551377,"small","C"
3342,50,38,12,29416.4038168675,"mid","C"
3343,29,22,7,13914.4524004195,"mid","C"
3344,52,5,47,36442.9463801962,"mid","C"
3345,60,35,25,149646.353068253,"mid","C"
3346,14,1,13,11318.1178812851,"mid","C"
3347,161,106,55,147526.858007357,"big","C"
3348,34,5,29,1650.27406923555,"mid","C"
3349,19,3,16,43020.4622917434,"mid","C"
3350,26,15,11,8055.71653683077,"mid","C"
3351,145,116,29,75183.993752853,"big","C"
3352,100,39,61,117898.896293925,"mid","C"
3353,38,4,34,6868.12467573819,"mid","C"
3354,58,15,43,46575.212099276,"mid","C"
3355,8,4,4,13964.3498669934,"small","C"
3356,16,10,6,9656.03969013425,"mid","C"
3357,65,42,23,121593.191562167,"mid","C"
3358,62,14,48,36970.485012066,"mid","C"
3359,60,17,43,162478.422485948,"mid","C"
3360,123,34,89,166178.320243921,"big","C"
3361,52,21,31,22788.1405676591,"mid","C"
3362,52,46,6,3078.00667776969,"mid","C"
3363,2,1,1,3631.99944875692,"small","C"
3364,64,12,52,31925.9018702658,"mid","C"
3365,113,106,7,229431.788476764,"big","C"
3366,2,0,2,1420.97078580129,"small","C"
3367,8,4,4,6992.82082018075,"small","C"
3368,111,103,8,343396.872626922,"big","C"
3369,16,1,15,37820.7740544468,"mid","C"
3370,54,21,33,75466.4456180875,"mid","C"
3371,131,74,57,146102.765646959,"big","C"
3372,109,46,63,146584.197261408,"big","C"
3373,93,87,6,160382.884481787,"mid","C"
3374,99,37,62,265752.798557309,"mid","C"
3375,13,9,4,19128.8321372533,"mid","C"
3376,72,64,8,27837.9590973488,"mid","C"
3377,96,29,67,17122.0167415497,"mid","C"
3378,194,185,9,202621.694364398,"big","C"
3379,7,2,5,644.592201849586,"small","C"
3380,59,42,17,84139.8363792608,"mid","C"
3381,62,26,36,38297.9370546719,"mid","C"
3382,207,190,17,75597.0872870002,"big","C"
3383,16,12,4,33094.8321439394,"mid","C"
3384,195,166,29,359185.860218855,"big","C"
3385,41,0,41,61783.4813929747,"mid","C"
3386,40,32,8,369.300653172877,"mid","C"
3387,153,29,124,183389.895697662,"big","C"
3388,80,6,74,110792.304751712,"mid","C"
3389,33,14,19,11864.8716950993,"mid","C"
3390,138,52,86,41670.0677116991,"big","C"
3391,22,13,9,20155.1167747145,"mid","C"
3392,70,3,67,96884.7519272522,"mid","C"
3393,61,48,13,133557.052477359,"mid","C"
3394,119,101,18,190129.495341904,"big","C"
3395,46,28,18,52481.7488637304,"mid","C"
3396,41,12,29,1249.45695052797,"mid","C"
3397,94,73,21,242564.90857606,"mid","C"
3398,23,10,13,3619.31163701787,"mid","C"
3399,108,73,35,234035.440514884,"big","C"
3400,254,5,249,210915.513726236,"big","C"
3401,126,25,101,59759.6056154571,"big","C"
3402,163,151,12,100896.826447671,"big","C"
3403,148,3,145,69290.9606952286,"big","C"
3404,37,24,13,65341.8048570936,"mid","C"
3405,146,89,57,160509.309225499,"big","C"
3406,118,68,50,181929.474140342,"big","C"
3407,50,46,4,49238.5061582746,"mid","C"
3408,216,172,44,170384.735080127,"big","C"
3409,62,29,33,17488.4455544939,"mid","C"
3410,78,25,53,76463.4538240353,"mid","C"
3411,10,2,8,1893.00262648993,"small","C"
3412,25,19,6,17841.6865174275,"mid","C"
3413,68,48,20,33975.1179995179,"mid","C"
3414,169,99,70,76365.7435021136,"big","C"
3415,18,2,16,5729.02134060507,"mid","C"
3416,96,63,33,80702.3490191133,"mid","C"
3417,87,48,39,95152.102788368,"mid","C"
3418,118,66,52,46173.2823636272,"big","C"
3419,192,38,154,216779.149004908,"big","C"
3420,142,75,67,88323.2817262722,"big","C"
3421,105,2,103,72535.1794244849,"big","C"
3422,42,8,34,36598.953999764,"mid","C"
3423,79,14,65,137208.199369013,"mid","C"
3424,65,39,26,119767.715911362,"mid","C"
3425,33,15,18,42221.0747953089,"mid","C"
3426,48,9,39,59431.9703011239,"mid","C"
3427,191,0,191,472472.114367991,"big","C"
3428,272,46,226,455797.867158129,"big","C"
3429,89,77,12,119217.177513744,"mid","C"
3430,8,0,8,1302.19124076249,"small","C"
3431,72,59,13,33113.6998884803,"mid","C"
3432,214,176,38,84302.1528539492,"big","C"
3433,68,19,49,116445.044070518,"mid","C"
3434,173,159,14,307716.27327883,"big","C"
3435,102,29,73,143737.444358198,"big","C"
3436,76,23,53,101479.366705429,"mid","C"
3437,127,110,17,158101.847489355,"big","C"
3438,163,79,84,94827.6282429007,"big","C"
3439,142,13,129,195580.652314221,"big","C"
3440,208,137,71,392798.938155395,"big","C"
3441,168,74,94,555169.701118263,"big","C"
3442,59,52,7,69210.2177248301,"mid","C"
3443,68,20,48,43812.6163305189,"mid","C"
3444,140,4,136,113086.166442436,"big","C"
3445,12,8,4,24905.4248185853,"mid","C"
3446,144,116,28,58982.0750105314,"big","C"
3447,31,17,14,29832.0189999787,"mid","C"
3448,16,15,1,9120.3287591274,"mid","C"
3449,57,35,22,42645.7229184068,"mid","C"
3450,117,62,55,105302.467197187,"big","C"
3451,110,96,14,20373.9811448357,"big","C"
3452,34,27,7,23389.2771106962,"mid","C"
3453,2,2,0,3499.09332224093,"small","C"
3454,74,30,44,26547.8445679398,"mid","C"
3455,69,10,59,58270.2742505468,"mid","C"
3456,118,33,85,271336.155673682,"big","C"
3457,61,49,12,108479.488054632,"mid","C"
3458,34,25,9,26051.1729932397,"mid","C"
3459,86,50,36,108749.385713006,"mid","C"
3460,54,44,10,26804.1145127793,"mid","C"
3461,12,2,10,21054.711495491,"mid","C"
3462,148,80,68,135919.688200775,"big","C"
3463,27,25,2,800.883369377982,"mid","C"
3464,11,7,4,22747.30741154,"mid","C"
3465,61,4,57,74122.7640684346,"mid","C"
3466,72,20,52,9691.7218623128,"mid","C"
3467,52,8,44,76990.4790754796,"mid","C"
3468,36,11,25,18288.8800264664,"mid","C"
3469,73,7,66,37898.5799364007,"mid","C"
3470,125,94,31,289895.620864309,"big","C"
3471,201,2,199,493413.405648316,"big","C"
3472,118,79,39,83683.1350157698,"big","C"
3473,42,22,20,42231.189799671,"mid","C"
3474,95,79,16,133544.177230938,"mid","C"
3475,6,3,3,6619.42960281036,"small","C"
3476,71,3,68,111311.120660044,"mid","C"
3477,104,8,96,139552.080509958,"big","C"
3478,88,68,20,251277.212265952,"mid","C"
3479,15,11,4,21850.7553616603,"mid","C"
3480,14,11,3,23059.1372138452,"mid","C"
3481,147,31,116,27530.4896080435,"big","C"
3482,85,80,5,18418.4827516961,"mid","C"
3483,61,27,34,134493.107242506,"mid","C"
3484,202,101,101,70883.3019093919,"big","C"
3485,107,36,71,154587.50110596,"big","C"
3486,56,18,38,188859.093057449,"mid","C"
3487,107,40,67,63660.7131655441,"big","C"
3488,192,72,120,591875.756210533,"big","C"
3489,48,23,25,40228.5083325657,"mid","C"
3490,57,8,49,39285.5582817301,"mid","C"
3491,185,166,19,423206.312234655,"big","C"
3492,48,39,9,63687.2066851508,"mid","C"
3493,96,65,31,36880.691391562,"mid","C"
3494,83,78,5,132716.240608724,"mid","C"
3495,98,3,95,189906.905041941,"mid","C"
3496,15,9,6,25402.5727873192,"mid","C"
3497,202,16,186,477108.038914732,"big","C"
3498,71,37,34,23905.4563935535,"mid","C"
3499,154,118,36,14120.2669712123,"big","C"
3500,49,48,1,28651.4089243285,"mid","C"
3501,68,50,18,68421.8926773313,"mid","C"
3502,42,13,29,33247.9595160283,"mid","C"
3503,27,19,8,19314.7110641602,"mid","C"
3504,67,28,39,195576.291588425,"mid","C"
3505,177,133,44,142122.479917328,"big","C"
3506,135,126,9,98477.888550888,"big","C"
3507,124,96,28,59509.9765955437,"big","C"
3508,43,34,9,60362.37988155,"mid","C"
3509,14,6,8,17355.3957409179,"mid","C"
3510,4,1,3,3430.28728186859,"small","C"
3511,133,36,97,226896.12675329,"big","C"
3512,79,46,33,67387.6884371517,"mid","C"
3513,14,0,14,9817.63141705996,"mid","C"
3514,91,35,56,55472.5161229606,"mid","C"
3515,23,4,19,19017.239157762,"mid","C"
3516,17,13,4,404.171091003223,"mid","C"
3517,4,4,0,3362.58560815771,"small","C"
3518,58,4,54,140440.191643847,"mid","C"
3519,32,28,4,3460.50351307906,"mid","C"
3520,50,14,36,87803.3966811673,"mid","C"
3521,228,191,37,62575.9168574591,"big","C"
3522,1,1,0,1875.82828534952,"small","C"
3523,21,14,7,10121.6138558163,"mid","C"
3524,89,3,86,84594.7705123313,"mid","C"
3525,1,1,0,1790.91918174084,"small","C"
3526,109,105,4,113795.88580773,"big","C"
3527,212,9,203,499916.752047863,"big","C"
3528,14,7,7,945.833915940553,"mid","C"
3529,101,82,19,156093.065139795,"big","C"
3530,144,21,123,375920.100106929,"big","C"
3531,37,3,34,76287.3763960869,"mid","C"
3532,22,17,5,60813.7574239252,"mid","C"
3533,69,60,9,29147.5080066368,"mid","C"
3534,29,16,13,7583.29122228965,"mid","C"
3535,123,114,9,126464.235229921,"big","C"
3536,102,10,92,93288.731638625,"big","C"
3537,78,75,3,124804.712645866,"mid","C"
3538,120,49,71,89841.3156231604,"big","C"
3539,175,151,24,28655.9195396215,"big","C"
3540,113,39,74,238767.81697354,"big","C"
3541,105,72,33,60244.4503871357,"big","C"
3542,231,157,74,86984.5991138698,"big","C"
3543,162,56,106,66578.6821370835,"big","C"
3544,63,53,10,4372.06030883463,"mid","C"
3545,78,3,75,4489.29491278076,"mid","C"
3546,19,9,10,9705.80310054566,"mid","C"
3547,70,51,19,126246.271896379,"mid","C"
3548,40,37,3,83886.1749287779,"mid","C"
3549,7,5,2,8990.54151263284,"small","C"
3550,147,125,22,157310.888457743,"big","C"
3551,25,13,12,11405.8699521855,"mid","C"
3552,115,71,44,78574.7277780375,"big","C"
3553,15,6,9,12357.539243406,"mid","C"
3554,202,81,121,239403.727595977,"big","C"
3555,48,33,15,23003.3938294244,"mid","C"
3556,57,29,28,95628.9749007659,"mid","C"
3557,45,20,25,28679.4565443641,"mid","C"
3558,6,2,4,8845.57640333892,"small","C"
3559,2,1,1,3495.67607287665,"small","C"
3560,39,4,35,69970.8531747509,"mid","C"
3561,61,34,27,20947.8581382856,"mid","C"
3562,31,3,28,78159.6354650483,"mid","C"
3563,97,31,66,120215.230371442,"mid","C"
3564,89,53,36,15717.507250939,"mid","C"
3565,90,83,7,168522.659497303,"mid","C"
3566,131,96,35,186406.203538277,"big","C"
3567,40,4,36,93175.8796570883,"mid","C"
3568,39,33,6,63843.7328786999,"mid","C"
3569,252,156,96,448719.101721132,"big","C"
3570,118,90,28,50302.0547442747,"big","C"
3571,47,26,21,92445.5975912072,"mid","C"
3572,20,3,17,9968.40522855807,"mid","C"
3573,234,163,71,677156.843902569,"big","C"
3574,35,31,4,1729.38014379033,"mid","C"
3575,101,19,82,192855.319384965,"big","C"
3576,55,54,1,32326.301841143,"mid","C"
3577,1,0,1,207.796461317284,"small","C"
3578,168,54,114,273014.380100885,"big","C"
3579,29,15,14,31310.595648206,"mid","C"
3580,41,1,40,59609.4845624705,"mid","C"
3581,6,3,3,2998.82132858677,"small","C"
3582,58,36,22,125414.638758061,"mid","C"
3583,53,3,50,126310.613355472,"mid","C"
3584,26,5,21,28287.1022788962,"mid","C"
3585,109,47,62,150794.869556395,"big","C"
3586,15,6,9,21975.9863948467,"mid","C"
3587,2,1,1,124.038164271178,"small","C"
3588,13,8,5,21371.7935391704,"mid","C"
3589,27,9,18,23287.0427916821,"mid","C"
3590,12,8,4,7423.57290318472,"mid","C"
3591,38,29,9,23816.5004115277,"mid","C"
3592,2,1,1,3164.34105264443,"small","C"
3593,70,38,32,19284.0570542589,"mid","C"
3594,114,17,97,78885.7572021216,"big","C"
3595,20,17,3,28479.4841654763,"mid","C"
3596,131,26,105,78668.5353893238,"big","C"
3597,89,40,49,29077.4611242367,"mid","C"
3598,21,8,13,7029.48352469884,"mid","C"
3599,98,74,24,78199.7103605285,"mid","C"
3600,17,6,11,14605.3943541172,"mid","C"
3601,90,49,41,155491.022376684,"mid","C"
3602,63,28,35,34374.3516146265,"mid","C"
3603,160,71,89,363066.979489581,"big","C"
3604,65,19,46,33210.187654137,"mid","C"
3605,115,105,10,69237.6976391314,"big","C"
3606,59,23,36,10155.0757183297,"mid","C"
3607,90,51,39,56980.6485905988,"mid","C"
3608,124,15,109,251457.349645848,"big","C"
3609,79,35,44,63256.8682501781,"mid","C"
3610,50,31,19,78338.5689613156,"mid","C"
3611,64,60,4,201590.07018924,"mid","C"
3612,135,13,122,187480.808392895,"big","C"
3613,66,13,53,67827.5849769257,"mid","C"
3614,40,30,10,123682.192628008,"mid","C"
3615,86,39,47,112945.656996132,"mid","C"
3616,42,32,10,94091.229633359,"mid","C"
3617,99,95,4,12497.683976513,"mid","C"
3618,59,19,40,47131.8621864236,"mid","C"
3619,37,20,17,48187.6823038143,"mid","C"
3620,2,0,2,3306.45420567958,"small","C"
3621,37,21,16,80985.774379276,"mid","C"
3622,76,54,22,137683.732619799,"mid","C"
3623,101,38,63,130938.236849815,"big","C"
3624,36,32,4,28046.1597575765,"mid","C"
3625,14,12,2,8076.04608432257,"mid","C"
3626,67,29,38,17151.8069086704,"mid","C"
3627,41,24,17,729.758809493267,"mid","C"
3628,173,103,70,80086.977713361,"big","C"
3629,260,119,141,322249.082650944,"big","C"
3630,72,66,6,43918.2126378828,"mid","C"
3631,70,16,54,68286.9007950415,"mid","C"
3632,13,13,0,4388.57750113356,"mid","C"
3633,158,112,46,464935.969419406,"big","C"
3634,124,74,50,341518.63743624,"big","C"
3635,41,40,1,50463.0739732405,"mid","C"
3636,139,101,38,276514.166998906,"big","C"
3637,59,49,10,8699.64066509718,"mid","C"
3638,12,7,5,17949.6722333665,"mid","C"
3639,46,19,27,115933.543497434,"mid","C"
3640,217,47,170,298114.745109298,"big","C"
3641,19,12,7,29538.2679108506,"mid","C"
3642,117,10,107,161928.489661119,"big","C"
3643,66,14,52,61691.1725923035,"mid","C"
3644,22,14,8,21531.6729006791,"mid","C"
3645,31,3,28,1134.00603585708,"mid","C"
3646,126,53,73,67475.7725242472,"big","C"
3647,121,76,45,158453.01899954,"big","C"
3648,186,7,179,176634.679414736,"big","C"
3649,36,29,7,14506.8983866361,"mid","C"
3650,108,33,75,99576.6284050036,"big","C"
3651,87,26,61,67501.6824891708,"mid","C"
3652,62,12,50,78794.8629600183,"mid","C"
3653,82,45,37,94017.2772910078,"mid","C"
3654,311,242,69,15524.8713966889,"big","C"
3655,10,10,0,1529.99849113692,"small","C"
3656,98,88,10,152884.533717734,"mid","C"
3657,180,24,156,211374.097706771,"big","C"
3658,42,24,18,77167.8727000651,"mid","C"
3659,60,6,54,29727.2724901581,"mid","C"
3660,215,184,31,299943.098554837,"big","C"
3661,153,102,51,67916.1544004393,"big","C"
3662,46,5,41,12783.3573167973,"mid","C"
3663,87,45,42,89260.4474477924,"mid","C"
3664,180,44,136,322088.180855229,"big","C"
3665,126,123,3,143103.202348859,"big","C"
3666,11,3,8,10263.5073425631,"mid","C"
3667,9,3,6,30364.0807496668,"small","C"
3668,134,110,24,151847.370728744,"big","C"
3669,13,7,6,28787.9034510343,"mid","C"
3670,218,204,14,352331.853796782,"big","C"
3671,80,28,52,229147.95837358,"mid","C"
3672,28,8,20,59363.8466531985,"mid","C"
3673,25,0,25,43546.2938130444,"mid","C"
3674,55,26,29,75575.158613987,"mid","C"
3675,233,28,205,186841.751876422,"big","C"
3676,222,100,122,454557.939380416,"big","C"
3677,8,7,1,10496.4233944724,"small","C"
3678,135,23,112,195777.292674785,"big","C"
3679,67,40,27,40748.2519239832,"mid","C"
3680,72,61,11,169615.121582814,"mid","C"
3681,91,8,83,124605.907605806,"mid","C"
3682,25,0,25,42906.881873964,"mid","C"
3683,219,197,22,44415.4541724051,"big","C"
3684,123,82,41,171153.213341219,"big","C"
3685,44,22,22,45552.374047481,"mid","C"
3686,97,23,74,11108.8216365344,"mid","C"
3687,43,32,11,90698.5634491869,"mid","C"
3688,25,2,23,8454.99834579562,"mid","C"
3689,79,55,24,173301.312363568,"mid","C"
3690,89,24,65,18357.0697281278,"mid","C"
3691,67,36,31,208723.734339905,"mid","C"
3692,10,9,1,5918.63138589592,"small","C"
3693,22,9,13,9303.7061651067,"mid","C"
3694,10,7,3,2106.71378894591,"small","C"
3695,75,20,55,73268.026920162,"mid","C"
3696,14,8,6,11239.8957757438,"mid","C"
3697,94,31,63,238251.77153144,"mid","C"
3698,109,37,72,127340.341071176,"big","C"
3699,150,46,104,289885.811171163,"big","C"
3700,68,4,64,86959.2699206632,"mid","C"
3701,309,206,103,241244.330279749,"big","C"
3702,19,2,17,42366.4243278319,"mid","C"
3703,67,4,63,118540.674684785,"mid","C"
3704,60,53,7,54793.0703895043,"mid","C"
3705,120,26,94,113047.972565028,"big","C"
3706,15,11,4,17645.7714702267,"mid","C"
3707,66,56,10,152841.60158655,"mid","C"
3708,152,24,128,32065.3795187901,"big","C"
3709,33,32,1,4462.43385611835,"mid","C"
3710,218,185,33,277225.452332205,"big","C"
3711,62,57,5,105851.994647702,"mid","C"
3712,17,15,2,19453.5416116316,"mid","C"
3713,50,32,18,114808.33900619,"mid","C"
3714,12,7,5,2700.68296446811,"mid","C"
3715,85,16,69,235583.370391757,"mid","C"
3716,59,10,49,107760.019007772,"mid","C"
3717,126,67,59,110770.97467451,"big","C"
3718,175,78,97,18744.4469767707,"big","C"
3719,64,44,20,27761.3994887991,"mid","C"
3720,21,9,12,2461.47671270183,"mid","C"
3721,65,10,55,6576.39331581314,"mid","C"
3722,222,117,105,48973.7107376434,"big","C"
3723,10,9,1,6097.20334374767,"small","C"
3724,62,53,9,8520.84614764048,"mid","C"
3725,8,2,6,2435.63047052128,"small","C"
3726,82,66,16,71583.8731569981,"mid","C"
3727,160,154,6,304580.402209806,"big","C"
3728,24,16,8,30167.9407559205,"mid","C"
3729,83,56,27,99253.9366874632,"mid","C"
3730,92,91,1,62701.9954433715,"mid","C"
3731,84,41,43,9000.06835240278,"mid","C"
3732,121,85,36,137655.634408792,"big","C"
3733,35,6,29,51360.547752781,"mid","C"
3734,3,2,1,1614.49994640309,"small","C"
3735,2,0,2,3912.88486055732,"small","C"
3736,266,147,119,377983.664166275,"big","C"
3737,105,74,31,240917.354473004,"big","C"
3738,148,147,1,65781.9017460869,"big","C"
3739,253,153,100,241033.013201868,"big","C"
3740,305,202,103,372942.426963277,"big","C"
3741,16,7,9,34738.870345346,"mid","C"
3742,154,63,91,359771.378052386,"big","C"
3743,126,89,37,100580.592687609,"big","C"
3744,30,30,0,6588.60510294114,"mid","C"
3745,70,55,15,152522.462719501,"mid","C"
3746,55,12,43,21982.2690805947,"mid","C"
3747,173,108,65,448525.673162565,"big","C"
3748,236,92,144,609273.594041028,"big","C"
3749,44,7,37,16247.4910587345,"mid","C"
3750,139,10,129,100755.194673267,"big","C"
3751,10,10,0,12152.9818839862,"small","C"
3752,46,28,18,12034.0252965331,"mid","C"
3753,87,26,61,119514.739453979,"mid","C"
3754,239,41,198,257842.69497637,"big","C"
3755,42,25,17,66260.0588770095,"mid","C"
3756,107,0,107,172568.51424772,"big","C"
3757,48,39,9,21250.3314850306,"mid","C"
3758,28,26,2,68060.0437848422,"mid","C"
3759,116,39,77,198767.544318383,"big","C"
3760,242,38,204,99781.1457318168,"big","C"
3761,1,1,0,3548.31831541364,"small","C"
3762,68,51,17,68801.003195026,"mid","C"
3763,50,30,20,30618.5519902767,"mid","C"
3764,81,26,55,52534.87858777,"mid","C"
3765,20,4,16,8414.5124180923,"mid","C"
3766,23,4,19,4463.88480706462,"mid","C"
3767,20,3,17,17419.2554976203,"mid","C"
3768,64,21,43,32502.4801254789,"mid","C"
3769,55,41,14,16837.8666364866,"mid","C"
3770,85,12,73,56086.4492294909,"mid","C"
3771,171,80,91,41765.8164303158,"big","C"
3772,57,47,10,114061.282581072,"mid","C"
3773,13,4,9,8381.08415886361,"mid","C"
3774,50,22,28,276.435623716833,"mid","C"
3775,88,22,66,24588.3866553379,"mid","C"
3776,73,26,47,1556.06166291118,"mid","C"
3777,9,9,0,8221.78083336963,"small","C"
3778,26,6,20,18479.8790229383,"mid","C"
3779,75,50,25,16534.9671669722,"mid","C"
3780,10,6,4,17130.1781919897,"small","C"
3781,137,112,25,337860.0180902,"big","C"
3782,6,4,2,5549.73737248296,"small","C"
3783,125,32,93,146502.045833655,"big","C"
3784,74,26,48,147486.565418875,"mid","C"
3785,183,86,97,267266.589019567,"big","C"
3786,203,137,66,120625.678667636,"big","C"
3787,88,50,38,63054.9397940475,"mid","C"
3788,179,58,121,15235.7978244427,"big","C"
3789,31,25,6,39589.0970151093,"mid","C"
3790,116,27,89,152444.95339013,"big","C"
3791,15,1,14,3199.80283380493,"mid","C"
3792,163,149,14,71353.3089031896,"big","C"
3793,160,138,22,109237.203172847,"big","C"
3794,75,5,70,106236.992172921,"mid","C"
3795,184,47,137,162789.274087813,"big","C"
3796,157,156,1,19443.7496370953,"big","C"
3797,170,41,129,150311.43555333,"big","C"
3798,17,1,16,58285.284152288,"mid","C"
3799,13,6,7,42567.0226895802,"mid","C"
3800,115,84,31,324384.681134786,"big","C"
3801,64,63,1,31936.6531205379,"mid","C"
3802,245,213,32,54203.0166352365,"big","C"
3803,4,1,3,5666.52057136599,"small","C"
3804,209,69,140,440506.344053056,"big","C"
3805,199,108,91,115967.873125104,"big","C"
3806,49,15,34,26395.3984174738,"mid","C"
3807,53,37,16,90950.2641292517,"mid","C"
3808,112,108,4,336947.550714744,"big","C"
3809,112,4,108,121439.480852557,"big","C"
3810,212,15,197,145081.684694795,"big","C"
3811,178,93,85,220342.209914624,"big","C"
3812,2,1,1,547.80548626744,"small","C"
3813,117,2,115,146574.998476303,"big","C"
3814,39,10,29,58225.4120821835,"mid","C"
3815,81,70,11,32061.5938706388,"mid","C"
3816,25,11,14,22817.409889113,"mid","C"
3817,187,129,58,379601.763718309,"big","C"
3818,5,2,3,5654.5126489933,"small","C"
3819,141,68,73,140905.658519224,"big","C"
3820,119,117,2,157855.853397709,"big","C"
3821,51,15,36,95693.8724029482,"mid","C"
3822,9,3,6,8320.08436828969,"small","C"
3823,36,2,34,48467.7714095789,"mid","C"
3824,124,76,48,130302.326660494,"big","C"
3825,216,46,170,433188.070118233,"big","C"
3826,53,27,26,101839.134223225,"mid","C"
3827,81,43,38,211915.285621384,"mid","C"
3828,92,57,35,31889.5205066239,"mid","C"
3829,72,56,16,19467.580437513,"mid","C"
3830,207,130,77,213647.595517331,"big","C"
3831,246,165,81,102037.948621744,"big","C"
3832,65,60,5,56430.8970733451,"mid","C"
3833,17,14,3,7855.39927370156,"mid","C"
3834,189,171,18,320500.067512872,"big","C"
3835,24,23,1,49754.3544380044,"mid","C"
3836,46,9,37,82381.8871388884,"mid","C"
3837,144,126,18,202837.35385184,"big","C"
3838,70,10,60,35921.068819051,"mid","C"
3839,68,7,61,21168.419427714,"mid","C"
3840,34,21,13,48672.8907785238,"mid","C"
3841,234,49,185,225032.698603226,"big","C"
3842,2,2,0,6697.56567139993,"small","C"
3843,55,32,23,47246.1824232042,"mid","C"
3844,9,3,6,10868.7459214581,"small","C"
3845,63,27,36,21419.6957507034,"mid","C"
3846,65,39,26,46334.9014685751,"mid","C"
3847,110,73,37,248478.552647029,"big","C"
3848,109,12,97,107780.811203863,"big","C"
3849,37,0,37,50797.3410659081,"mid","C"
3850,35,27,8,57159.6532371395,"mid","C"
3851,183,60,123,150849.462730617,"big","C"
3852,11,3,8,14414.6001416421,"mid","C"
3853,45,20,25,54322.6056132401,"mid","C"
3854,56,21,35,119529.277115299,"mid","C"
3855,127,46,81,154520.090011515,"big","C"
3856,130,31,99,134095.698238991,"big","C"
3857,65,19,46,109916.299777322,"mid","C"
3858,150,68,82,261701.698680477,"big","C"
3859,79,48,31,14464.1053074252,"mid","C"
3860,38,16,22,3963.29489892493,"mid","C"
3861,79,18,61,105390.097462837,"mid","C"
3862,56,41,15,114993.527008466,"mid","C"
3863,209,98,111,141129.129596606,"big","C"
3864,96,88,8,146667.48534235,"mid","C"
3865,106,104,2,208754.671886695,"big","C"
3866,37,15,22,2010.94224023976,"mid","C"
3867,149,76,73,151695.946742168,"big","C"
3868,14,14,0,25744.1464402023,"mid","C"
3869,50,12,38,134887.569283957,"mid","C"
3870,214,27,187,356511.414315362,"big","C"
3871,2,1,1,3075.85500318658,"small","C"
3872,10,5,5,840.416619072482,"small","C"
3873,25,7,18,47669.8789666902,"mid","C"
3874,80,49,31,24900.3921603752,"mid","C"
3875,13,3,10,12204.3836263166,"mid","C"
3876,21,14,7,55541.9101639791,"mid","C"
3877,78,55,23,106588.144165809,"mid","C"
3878,97,22,75,26155.5928551869,"mid","C"
3879,88,85,3,78100.1178983533,"mid","C"
3880,258,148,110,526245.961364437,"big","C"
3881,257,218,39,230371.150430449,"big","C"
3882,23,9,14,47165.1548234628,"mid","C"
3883,18,12,6,44438.4721476414,"mid","C"
3884,156,78,78,563213.199110706,"big","C"
3885,64,31,33,31159.4795847438,"mid","C"
3886,83,67,16,68895.7929486582,"mid","C"
3887,74,67,7,33054.4362154345,"mid","C"
3888,74,21,53,26601.3616032025,"mid","C"
3889,39,16,23,43791.2589983903,"mid","C"
3890,191,112,79,515218.63904439,"big","C"
3891,23,2,21,34917.1294427329,"mid","C"
3892,156,89,67,117049.698557041,"big","C"
3893,136,64,72,102149.876118029,"big","C"
3894,84,83,1,136169.088931408,"mid","C"
3895,45,7,38,37271.7072661071,"mid","C"
3896,19,3,16,38953.1229834276,"mid","C"
3897,126,37,89,47113.9055934501,"big","C"
3898,106,27,79,31756.9437402547,"big","C"
3899,30,11,19,99476.7469658424,"mid","C"
3900,4,1,3,154.117989099377,"small","C"
3901,24,3,21,48826.964482011,"mid","C"
3902,1,1,0,1258.7186687087,"small","C"
3903,85,41,44,92782.0592150863,"mid","C"
3904,327,211,116,298931.449621954,"big","C"
3905,8,5,3,657.28849866622,"small","C"
3906,64,59,5,71493.1136127526,"mid","C"
3907,64,7,57,89509.9628295198,"mid","C"
3908,78,15,63,177045.784156808,"mid","C"
3909,12,4,8,5916.92744129996,"mid","C"
3910,15,3,12,15720.7369641716,"mid","C"
3911,16,0,16,3664.33950705866,"mid","C"
3912,69,35,34,65554.1484651709,"mid","C"
3913,178,115,63,292553.864372937,"big","C"
3914,59,51,8,88092.2313873331,"mid","C"
3915,195,171,24,306428.325731495,"big","C"
3916,68,6,62,85084.1269364301,"mid","C"
3917,28,8,20,13034.598997615,"mid","C"
3918,71,27,44,82710.2690369162,"mid","C"
3919,281,19,262,140917.892752448,"big","C"
3920,26,16,10,45768.0024230482,"mid","C"
3921,210,121,89,28902.512665682,"big","C"
3922,118,81,37,175677.809764531,"big","C"
3923,62,46,16,112437.034929893,"mid","C"
3924,107,4,103,162005.46531581,"big","C"
3925,13,2,11,3116.11273472648,"mid","C"
3926,73,10,63,145232.84463293,"mid","C"
3927,62,32,30,5406.09884955336,"mid","C"
3928,116,92,24,151434.128926072,"big","C"
3929,128,109,19,360876.744269291,"big","C"
3930,41,23,18,76488.6089049395,"mid","C"
3931,80,40,40,119528.843286864,"mid","C"
3932,146,31,115,1353.8350150935,"big","C"
3933,19,3,16,15295.8685972589,"mid","C"
3934,29,22,7,14276.0576540876,"mid","C"
3935,6,1,5,3481.01835732039,"small","C"
3936,27,17,10,16327.3410858457,"mid","C"
3937,84,29,55,116644.236950966,"mid","C"
3938,26,13,13,51834.1616036377,"mid","C"
3939,209,158,51,332868.827537934,"big","C"
3940,196,36,160,51476.2162695665,"big","C"
3941,12,9,3,12639.1476854756,"mid","C"
3942,14,1,13,17956.7205936671,"mid","C"
3943,52,17,35,89590.0640012702,"mid","C"
3944,73,39,34,17098.7279054495,"mid","C"
3945,120,41,79,61555.6181064067,"big","C"
3946,50,24,26,25837.0483846402,"mid","C"
3947,14,11,3,29819.8855524775,"mid","C"
3948,38,11,27,101913.843119587,"mid","C"
3949,123,22,101,239818.214415754,"big","C"
3950,77,28,49,83295.53332627,"mid","C"
3951,137,135,2,167715.773934923,"big","C"
3952,113,98,15,288141.745475535,"big","C"
3953,201,180,21,756247.910822681,"big","C"
3954,35,27,8,60843.6039430339,"mid","C"
3955,94,73,21,205862.923324378,"mid","C"
3956,107,4,103,157714.376738742,"big","C"
3957,8,6,2,21298.6294952354,"small","C"
3958,99,62,37,108394.112675951,"mid","C"
3959,163,57,106,25528.3664708717,"big","C"
3960,13,3,10,28143.0601005155,"mid","C"
3961,24,5,19,42888.4892302156,"mid","C"
3962,63,54,9,174909.312548707,"mid","C"
3963,36,33,3,79664.1728121938,"mid","C"
3964,164,52,112,221752.435351973,"big","C"
3965,168,85,83,357072.637945827,"big","C"
3966,23,2,21,62738.0588754491,"mid","C"
3967,78,71,7,117755.145771188,"mid","C"
3968,70,51,19,19913.2346058136,"mid","C"
3969,208,22,186,143722.900355655,"big","C"
3970,10,3,7,11233.8956490739,"small","C"
3971,83,55,28,134680.925246706,"mid","C"
3972,69,22,47,147384.149547686,"mid","C"
3973,100,95,5,16582.1066793622,"mid","C"
3974,5,3,2,2998.73529512392,"small","C"
3975,77,19,58,62602.4522436282,"mid","C"
3976,18,16,2,46249.9329499809,"mid","C"
3977,159,60,99,70870.109595155,"big","C"
3978,33,9,24,38790.7678800419,"mid","C"
3979,28,6,22,35960.3168884854,"mid","C"
3980,46,3,43,108792.603969469,"mid","C"
3981,99,67,32,26657.2846010699,"mid","C"
3982,46,30,16,58643.0645885696,"mid","C"
3983,33,13,20,46291.5589030355,"mid","C"
3984,39,17,22,16473.8294375678,"mid","C"
3985,48,2,46,84547.9958409914,"mid","C"
3986,49,19,30,26184.286262429,"mid","C"
3987,18,10,8,25513.7190839411,"mid","C"
3988,86,58,28,103510.851027571,"mid","C"
3989,140,15,125,183706.015278921,"big","C"
3990,133,38,95,241584.737283927,"big","C"
3991,103,98,5,81046.6991420368,"big","C"
3992,5,2,3,7100.58191055626,"small","C"
3993,29,19,10,33650.8863896944,"mid","C"
3994,206,193,13,210412.716694217,"big","C"
3995,49,44,5,112284.39176025,"mid","C"
3996,65,43,22,87790.2413430315,"mid","C"
3997,60,38,22,37806.1232559948,"mid","C"
3998,194,160,34,225862.899733471,"big","C"
3999,6,3,3,9324.06631641891,"small","C"
4000,21,2,19,29821.2596142188,"mid","C"
4001,217,81,136,20655.8933682294,"big","D"
4002,42,14,28,64596.9509869892,"mid","D"
4003,183,95,88,123059.816525664,"big","D"
4004,57,17,40,5148.99151580351,"mid","D"
4005,55,21,34,160731.196919111,"mid","D"
4006,30,19,11,74932.212439624,"mid","D"
4007,100,68,32,336130.175522723,"mid","D"
4008,161,10,151,269385.713664911,"big","D"
4009,141,100,41,344921.569894729,"big","D"
4010,105,59,46,17377.1726127219,"big","D"
4011,59,55,4,56682.48566311,"mid","D"
4012,63,12,51,147930.918507808,"mid","D"
4013,5,3,2,1522.4428373144,"small","D"
4014,123,51,72,310417.109151972,"big","D"
4015,31,12,19,78650.6143818945,"mid","D"
4016,114,99,15,42152.6414684315,"big","D"
4017,83,32,51,115135.873561612,"mid","D"
4018,16,8,8,16719.8860243168,"mid","D"
4019,18,14,4,47866.2219593984,"mid","D"
4020,6,2,4,17687.7057734622,"small","D"
4021,68,2,66,33258.156234004,"mid","D"
4022,323,51,272,182637.189600003,"big","D"
4023,46,28,18,20047.1823786258,"mid","D"
4024,30,3,27,13625.2421343259,"mid","D"
4025,65,9,56,132846.024425507,"mid","D"
4026,86,84,2,82457.704592819,"mid","D"
4027,58,57,1,50528.5057652544,"mid","D"
4028,84,71,13,20883.2996867027,"mid","D"
4029,55,29,26,91639.8167648217,"mid","D"
4030,159,32,127,93196.9645114178,"big","D"
4031,25,3,22,48859.7696950184,"mid","D"
4032,46,12,34,74061.5404542428,"mid","D"
4033,21,16,5,59097.2801865903,"mid","D"
4034,13,2,11,22803.2190553292,"mid","D"
4035,174,75,99,174510.832629635,"big","D"
4036,33,30,3,56718.4027478465,"mid","D"
4037,39,27,12,55090.4176258767,"mid","D"
4038,9,8,1,5146.11856605311,"small","D"
4039,37,33,4,88011.7804873635,"mid","D"
4040,21,7,14,53542.782741454,"mid","D"
4041,8,6,2,5849.71840660099,"small","D"
4042,151,23,128,151875.019661182,"big","D"
4043,5,1,4,6572.67825778867,"small","D"
4044,7,0,7,8150.62215091762,"small","D"
4045,80,18,62,103226.467692682,"mid","D"
4046,42,16,26,43570.1014136101,"mid","D"
4047,154,7,147,167308.248643065,"big","D"
4048,214,4,210,235265.065882827,"big","D"
4049,24,12,12,19853.0362069196,"mid","D"
4050,185,143,42,379653.360085428,"big","D"
4051,86,51,35,21639.6484624137,"mid","D"
4052,192,90,102,114933.024633775,"big","D"
4053,97,21,76,9405.9935069909,"mid","D"
4054,29,28,1,12853.4469855539,"mid","D"
4055,2,1,1,2709.56771143811,"small","D"
4056,59,17,42,354.600119838048,"mid","D"
4057,152,46,106,74048.7478865324,"big","D"
4058,8,2,6,14667.9666718219,"small","D"
4059,44,2,42,86170.0222816924,"mid","D"
4060,105,5,100,12648.5377704651,"big","D"
4061,45,1,44,116826.159325869,"mid","D"
4062,145,116,29,31867.0981110153,"big","D"
4063,28,12,16,64202.4813175214,"mid","D"
4064,15,5,10,7726.58812736168,"mid","D"
4065,58,29,29,56707.1733711462,"mid","D"
4066,28,23,5,63421.5063407964,"mid","D"
4067,64,44,20,3012.49149817311,"mid","D"
4068,129,104,25,133111.059007863,"big","D"
4069,171,152,19,156195.413550483,"big","D"
4070,29,29,0,41723.008035094,"mid","D"
4071,67,44,23,93812.2733519753,"mid","D"
4072,142,89,53,336374.500287893,"big","D"
4073,28,27,1,74672.2486088692,"mid","D"
4074,97,50,47,97160.7882869429,"mid","D"
4075,67,20,47,54548.2378569479,"mid","D"
4076,29,8,21,50550.8448258244,"mid","D"
4077,22,8,14,79583.1650710844,"mid","D"
4078,2,1,1,2135.72405549442,"small","D"
4079,1,0,1,771.80318771544,"small","D"
4080,162,41,121,34884.4916391662,"big","D"
4081,149,132,17,131718.349965742,"big","D"
4082,99,71,28,152784.646482237,"mid","D"
4083,155,106,49,119258.696585864,"big","D"
4084,4,4,0,3871.32221614437,"small","D"
4085,132,116,16,100246.15299578,"big","D"
4086,18,11,7,16370.8773801245,"mid","D"
4087,14,7,7,39314.8176923271,"mid","D"
4088,101,90,11,152429.421303875,"big","D"
4089,190,183,7,408287.370950804,"big","D"
4090,37,34,3,27816.4422681616,"mid","D"
4091,18,16,2,21641.3685650178,"mid","D"
4092,126,108,18,189504.013554797,"big","D"
4093,122,40,82,102441.89770552,"big","D"
4094,14,5,9,13331.2616263536,"mid","D"
4095,58,18,40,64356.17842875,"mid","D"
4096,19,16,3,16865.640878921,"mid","D"
4097,50,20,30,12573.6431204553,"mid","D"
4098,141,112,29,31323.9973531087,"big","D"
4099,101,84,17,23678.4340758328,"big","D"
4100,133,106,27,237345.014148225,"big","D"
4101,2,2,0,310.60158863143,"small","D"
4102,66,13,53,5593.48309547025,"mid","D"
4103,76,44,32,32948.9157861413,"mid","D"
4104,120,8,112,14791.4036530338,"big","D"
4105,88,57,31,36006.0313897803,"mid","D"
4106,31,6,25,32239.2524857995,"mid","D"
4107,3,2,1,3097.54321564531,"small","D"
4108,127,45,82,24843.4174765314,"big","D"
4109,94,21,73,66572.5833688636,"mid","D"
4110,74,35,39,42968.4304230842,"mid","D"
4111,65,47,18,97826.8834994546,"mid","D"
4112,38,14,24,7847.8285790937,"mid","D"
4113,102,34,68,72442.3973840219,"big","D"
4114,77,60,17,46084.3535709691,"mid","D"
4115,83,66,17,130051.297231172,"mid","D"
4116,123,16,107,77109.5332703353,"big","D"
4117,57,2,55,8211.92356937035,"mid","D"
4118,23,4,19,25961.4437483038,"mid","D"
4119,10,7,3,15311.5007638415,"small","D"
4120,75,22,53,3922.68133651355,"mid","D"
4121,77,28,49,66637.5974625721,"mid","D"
4122,114,99,15,61288.8828391297,"big","D"
4123,95,32,63,78195.3447238128,"mid","D"
4124,109,47,62,162442.377407523,"big","D"
4125,20,3,17,27915.7277150133,"mid","D"
4126,11,1,10,25401.825856397,"mid","D"
4127,101,87,14,5332.42278272488,"big","D"
4128,22,7,15,9644.17453175146,"mid","D"
4129,117,50,67,265208.485582957,"big","D"
4130,137,96,41,70299.7535036086,"big","D"
4131,63,37,26,91204.8031568112,"mid","D"
4132,52,12,40,10715.218857617,"mid","D"
4133,21,1,20,4934.31789667337,"mid","D"
4134,23,17,6,7079.89268153559,"mid","D"
4135,73,7,66,86701.4969916613,"mid","D"
4136,9,1,8,13137.597403711,"small","D"
4137,127,61,66,18554.7342424756,"big","D"
4138,86,72,14,149664.244194049,"mid","D"
4139,33,7,26,11563.7453128883,"mid","D"
4140,95,5,90,66419.8451744899,"mid","D"
4141,62,61,1,122123.81284932,"mid","D"
4142,17,6,11,370.872198081013,"mid","D"
4143,110,35,75,36073.1134117372,"big","D"
4144,57,18,39,50982.4775818537,"mid","D"
4145,86,32,54,14350.7231199404,"mid","D"
4146,73,50,23,12438.7522300564,"mid","D"
4147,25,7,18,40467.0578308612,"mid","D"
4148,62,34,28,27869.7333677924,"mid","D"
4149,26,26,0,11834.7467720619,"mid","D"
4150,169,22,147,243222.126173613,"big","D"
4151,43,29,14,4804.67872493526,"mid","D"
4152,72,45,27,69431.5856228796,"mid","D"
4153,227,112,115,162519.814966127,"big","D"
4154,15,8,7,11663.6225252616,"mid","D"
4155,51,8,43,112427.261898904,"mid","D"
4156,1,1,0,1016.33629483524,"small","D"
4157,52,43,9,147625.226019154,"mid","D"
4158,186,37,149,286947.396045362,"big","D"
4159,61,9,52,45013.5851972232,"mid","D"
4160,47,38,9,66858.4455410385,"mid","D"
4161,33,26,7,48065.6269073633,"mid","D"
4162,26,10,16,38658.1474402959,"mid","D"
4163,14,8,6,22890.6191142158,"mid","D"
4164,37,23,14,24986.3995185451,"mid","D"
4165,108,107,1,122485.643033321,"big","D"
4166,16,7,9,11181.5675315332,"mid","D"
4167,59,4,55,123777.125915184,"mid","D"
4168,32,23,9,50145.5489274008,"mid","D"
4169,177,91,86,477502.808810281,"big","D"
4170,157,109,48,170495.063345644,"big","D"
4171,239,104,135,23978.3846945871,"big","D"
4172,27,18,9,17097.6202680262,"mid","D"
4173,155,118,37,225839.782204665,"big","D"
4174,53,33,20,120728.925079282,"mid","D"
4175,67,7,60,169639.131440915,"mid","D"
4176,65,65,0,24044.7769804579,"mid","D"
4177,40,26,14,40210.9389772123,"mid","D"
4178,30,1,29,63963.9684149686,"mid","D"
4179,206,197,9,270645.198533185,"big","D"
4180,37,1,36,48224.2213945458,"mid","D"
4181,6,6,0,6332.71524182937,"small","D"
4182,224,58,166,78482.6644045273,"big","D"
4183,173,142,31,154464.143685074,"big","D"
4184,90,20,70,177726.837786124,"mid","D"
4185,140,30,110,350400.628467366,"big","D"
4186,157,47,110,312698.396628112,"big","D"
4187,209,26,183,52954.8904434904,"big","D"
4188,66,39,27,111300.449887098,"mid","D"
4189,157,17,140,498329.94842711,"big","D"
4190,8,2,6,5459.33624803869,"small","D"
4191,7,4,3,7448.70628928325,"small","D"
4192,73,1,72,145488.422770713,"mid","D"
4193,91,11,80,14436.1248875238,"mid","D"
4194,75,60,15,164205.464910793,"mid","D"
4195,67,16,51,110932.91616544,"mid","D"
4196,5,3,2,3088.62168559355,"small","D"
4197,84,7,77,77308.4926890881,"mid","D"
4198,75,4,71,157460.150151043,"mid","D"
4199,28,12,16,20119.3676146622,"mid","D"
4200,216,49,167,612994.777991785,"big","D"
4201,13,12,1,25677.1180448291,"mid","D"
4202,129,109,20,159669.670678697,"big","D"
4203,152,74,78,38167.4658075996,"big","D"
4204,146,116,30,144476.636366442,"big","D"
4205,13,10,3,6813.94456036907,"mid","D"
4206,18,4,14,3188.66021277419,"mid","D"
4207,46,4,42,15238.9497790763,"mid","D"
4208,339,86,253,355038.900664291,"big","D"
4209,11,4,7,6236.56669679291,"mid","D"
4210,165,132,33,371961.953478609,"big","D"
4211,9,3,6,4889.03160028328,"small","D"
4212,15,3,12,25846.3872792483,"mid","D"
4213,22,7,15,11097.85548581,"mid","D"
4214,18,14,4,5016.6972916571,"mid","D"
4215,142,102,40,38434.3531854566,"big","D"
4216,135,32,103,236068.983877134,"big","D"
4217,68,33,35,28273.3037279974,"mid","D"
4218,2,2,0,1386.97613391236,"small","D"
4219,6,3,3,230.113468309126,"small","D"
4220,330,139,191,191659.877061056,"big","D"
4221,10,5,5,13833.9864674085,"small","D"
4222,86,48,38,4209.11210021692,"mid","D"
4223,141,66,75,170554.321032486,"big","D"
4224,99,56,43,52669.1800028407,"mid","D"
4225,258,96,162,164423.206697322,"big","D"
4226,57,37,20,46450.0062981435,"mid","D"
4227,26,8,18,21592.8223294962,"mid","D"
4228,128,80,48,100119.040050713,"big","D"
4229,46,4,42,16818.9989751941,"mid","D"
4230,300,32,268,690072.06683637,"big","D"
4231,5,2,3,3961.80729409584,"small","D"
4232,68,43,25,173228.362739201,"mid","D"
4233,65,21,44,42714.9031748468,"mid","D"
4234,134,67,67,248973.245130721,"big","D"
4235,65,27,38,27428.8682002806,"mid","D"
4236,202,10,192,497557.028871884,"big","D"
4237,6,0,6,2501.27435115578,"small","D"
4238,41,24,17,48948.5332048582,"mid","D"
4239,165,33,132,147250.276563737,"big","D"
4240,69,26,43,38871.1687350147,"mid","D"
4241,65,16,49,68935.4312638804,"mid","D"
4242,83,49,34,102693.422633668,"mid","D"
4243,71,16,55,6953.02824626951,"mid","D"
4244,93,54,39,53849.7420668477,"mid","D"
4245,72,44,28,154162.918634457,"mid","D"
4246,5,2,3,608.104064105658,"small","D"
4247,9,4,5,18713.6804429087,"small","D"
4248,54,46,8,44068.2419650345,"mid","D"
4249,108,73,35,43094.6622558018,"big","D"
4250,153,138,15,103363.255152058,"big","D"
4251,177,94,83,134760.968602569,"big","D"
4252,7,4,3,6631.94176353896,"small","D"
4253,94,33,61,123893.939897861,"mid","D"
4254,90,62,28,122224.953931312,"mid","D"
4255,96,19,77,165313.307842972,"mid","D"
4256,18,4,14,12958.9000809028,"mid","D"
4257,6,2,4,531.472673059422,"small","D"
4258,156,114,42,376236.04230929,"big","D"
4259,28,22,6,39792.3043726449,"mid","D"
4260,41,27,14,72317.8554944772,"mid","D"
4261,152,119,33,348283.599422433,"big","D"
4262,263,107,156,373414.126536975,"big","D"
4263,140,11,129,375222.13576897,"big","D"
4264,173,69,104,165253.807243015,"big","D"
4265,137,105,32,292460.874733247,"big","D"
4266,19,15,4,45953.0702355983,"mid","D"
4267,93,70,23,256568.381250442,"mid","D"
4268,58,31,27,37049.9729223715,"mid","D"
4269,96,42,54,132576.809051949,"mid","D"
4270,6,4,2,13287.4762376779,"small","D"
4271,23,22,1,35433.046004202,"mid","D"
4272,9,6,3,6137.31348794647,"small","D"
4273,74,73,1,96222.7219149235,"mid","D"
4274,208,119,89,449255.03434734,"big","D"
4275,70,58,12,41120.3749114181,"mid","D"
4276,33,14,19,5326.61480308482,"mid","D"
4277,21,12,9,6173.50608860208,"mid","D"
4278,89,59,30,122789.049711565,"mid","D"
4279,72,42,30,145771.125753045,"mid","D"
4280,11,8,3,21112.22629146,"mid","D"
4281,97,91,6,81489.3466596381,"mid","D"
4282,108,46,62,44596.8334421888,"big","D"
4283,77,57,20,166424.518408523,"mid","D"
4284,76,54,22,5665.73537681954,"mid","D"
4285,60,42,18,81270.5006766324,"mid","D"
4286,27,9,18,26957.2536069638,"mid","D"
4287,163,60,103,285490.075602054,"big","D"
4288,20,19,1,14616.8323449153,"mid","D"
4289,167,40,127,143507.398926471,"big","D"
4290,143,22,121,295336.781710509,"big","D"
4291,94,16,78,91984.124245245,"mid","D"
4292,80,22,58,131576.921359012,"mid","D"
4293,125,122,3,38522.9391992149,"big","D"
4294,80,15,65,180714.82838861,"mid","D"
4295,103,26,77,179247.875934481,"big","D"
4296,80,61,19,143386.18651138,"mid","D"
4297,36,4,32,5249.12843755406,"mid","D"
4298,347,232,115,199542.674767447,"big","D"
4299,228,39,189,376867.4358206,"big","D"
4300,56,50,6,59984.6816864308,"mid","D"
4301,152,59,93,74159.4496804696,"big","D"
4302,2,0,2,2667.63352284489,"small","D"
4303,130,21,109,95245.8456034843,"big","D"
4304,15,8,7,845.644290155243,"mid","D"
4305,18,9,9,30542.3556092849,"mid","D"
4306,12,0,12,15695.4987062809,"mid","D"
4307,24,1,23,25406.5127676522,"mid","D"
4308,165,5,160,38555.3549832671,"big","D"
4309,170,159,11,16372.0429648088,"big","D"
4310,104,2,102,128978.747671407,"big","D"
4311,111,101,10,259108.903486639,"big","D"
4312,37,12,25,54231.6900921908,"mid","D"
4313,17,10,7,5818.56510889488,"mid","D"
4314,7,6,1,4840.74065278427,"small","D"
4315,98,27,71,81746.159346486,"mid","D"
4316,14,6,8,24566.8668534161,"mid","D"
4317,60,6,54,56882.8322376426,"mid","D"
4318,37,26,11,59421.815173382,"mid","D"
4319,51,48,3,130338.738732189,"mid","D"
4320,68,43,25,23516.080960913,"mid","D"
4321,152,105,47,122166.633258445,"big","D"
4322,90,65,25,149257.360185354,"mid","D"
4323,170,92,78,413154.480581395,"big","D"
4324,58,30,28,22360.8149361911,"mid","D"
4325,115,83,32,211792.759215354,"big","D"
4326,112,94,18,34806.8874927616,"big","D"
4327,45,27,18,125496.57970605,"mid","D"
4328,43,11,32,132823.598297218,"mid","D"
4329,145,135,10,165619.863649734,"big","D"
4330,89,23,66,128523.405166568,"mid","D"
4331,17,13,4,20422.3270396732,"mid","D"
4332,187,94,93,668615.354812904,"big","D"
4333,149,101,48,201404.11045756,"big","D"
4334,145,21,124,210401.426581356,"big","D"
4335,119,51,68,35103.5240054966,"big","D"
4336,14,5,9,4120.64849444727,"mid","D"
4337,61,4,57,48977.6545917518,"mid","D"
4338,111,102,9,216619.811689149,"big","D"
4339,71,71,0,32928.062853123,"mid","D"
4340,38,20,18,26534.9108575329,"mid","D"
4341,92,87,5,16692.9828027363,"mid","D"
4342,159,43,116,62004.8258725777,"big","D"
4343,148,89,59,109398.352506904,"big","D"
4344,41,22,19,56445.5412623521,"mid","D"
4345,37,22,15,19026.2347864959,"mid","D"
4346,59,20,39,161348.495725668,"mid","D"
4347,103,29,74,66901.6839448486,"big","D"
4348,72,67,5,36845.5858998915,"mid","D"
4349,50,30,20,89101.5419324281,"mid","D"
4350,14,4,10,41053.7720911177,"mid","D"
4351,22,6,16,48107.9227090981,"mid","D"
4352,226,209,17,434192.387985824,"big","D"
4353,103,42,61,41760.5199061164,"big","D"
4354,36,10,26,46156.8933788749,"mid","D"
4355,118,108,10,233351.006790762,"big","D"
4356,36,21,15,19414.2560726885,"mid","D"
4357,72,38,34,99567.7379976055,"mid","D"
4358,228,212,16,76114.0721408977,"big","D"
4359,96,43,53,99312.4223612194,"mid","D"
4360,99,88,11,185432.085998996,"mid","D"
4361,86,60,26,164038.314586603,"mid","D"
4362,22,14,8,41214.6009181305,"mid","D"
4363,91,42,49,86063.3180681931,"mid","D"
4364,24,0,24,5583.17383643986,"mid","D"
4365,145,12,133,274274.500490793,"big","D"
4366,45,36,9,78899.4218979425,"mid","D"
4367,19,5,14,63251.9600292522,"mid","D"
4368,140,83,57,324286.809527834,"big","D"
4369,111,48,63,87827.3923208908,"big","D"
4370,43,5,38,6449.22456649308,"mid","D"
4371,323,261,62,689892.464271714,"big","D"
4372,25,16,9,4695.64492494359,"mid","D"
4373,37,35,2,87327.7032161478,"mid","D"
4374,142,100,42,280005.416598298,"big","D"
4375,171,3,168,101062.292444951,"big","D"
4376,59,36,23,11697.3369134553,"mid","D"
4377,7,1,6,10217.5840023232,"small","D"
4378,73,42,31,147553.75003256,"mid","D"
4379,50,3,47,12095.7795225491,"mid","D"
4380,107,61,46,87904.1411331458,"big","D"
4381,27,5,22,10737.3519631359,"mid","D"
4382,98,58,40,101122.014385422,"mid","D"
4383,3,0,3,24.321005601367,"small","D"
4384,19,13,6,2343.02068180051,"mid","D"
4385,15,10,5,10960.0877172402,"mid","D"
4386,64,15,49,95270.4005918463,"mid","D"
4387,25,14,11,18437.2984175405,"mid","D"
4388,25,5,20,35935.2366653117,"mid","D"
4389,3,2,1,4716.70274891835,"small","D"
4390,130,2,128,26882.9373127386,"big","D"
4391,17,7,10,22517.3925268146,"mid","D"
4392,184,21,163,90173.5652296646,"big","D"
4393,250,241,9,274878.707930168,"big","D"
4394,111,91,20,23806.7600547462,"big","D"
4395,261,233,28,323060.464807231,"big","D"
4396,14,5,9,23267.1394765975,"mid","D"
4397,70,7,63,91185.8213001639,"mid","D"
4398,126,95,31,179191.143580388,"big","D"
4399,84,82,2,207540.697444505,"mid","D"
4400,153,53,100,202261.910137728,"big","D"
4401,47,7,40,61375.1944015699,"mid","D"
4402,13,2,11,3577.69606023662,"mid","D"
4403,27,5,22,37197.8142925813,"mid","D"
4404,154,22,132,231156.974497614,"big","D"
4405,17,10,7,9876.82383904339,"mid","D"
4406,45,4,41,150362.420781026,"mid","D"
4407,69,64,5,144727.227705734,"mid","D"
4408,11,9,2,10704.8304778046,"mid","D"
4409,70,67,3,125010.737790112,"mid","D"
4410,32,9,23,41567.8326362592,"mid","D"
4411,23,1,22,17093.1900122297,"mid","D"
4412,101,27,74,54728.8760406965,"big","D"
4413,74,34,40,125167.954305904,"mid","D"
4414,88,39,49,94396.0477407837,"mid","D"
4415,68,62,6,88649.0879892959,"mid","D"
4416,25,19,6,39485.7893728191,"mid","D"
4417,212,141,71,38030.3125051891,"big","D"
4418,143,19,124,42162.8033706981,"big","D"
4419,12,5,7,7892.1965978076,"mid","D"
4420,26,11,15,18151.0440367635,"mid","D"
4421,26,2,24,39678.9947465556,"mid","D"
4422,15,13,2,35095.9271833858,"mid","D"
4423,138,66,72,80654.5457523617,"big","D"
4424,45,13,32,65911.5088115874,"mid","D"
4425,177,172,5,76049.9617807087,"big","D"
4426,37,27,10,50843.5908558493,"mid","D"
4427,47,18,29,6818.56345974648,"mid","D"
4428,20,12,8,20065.0355067955,"mid","D"
4429,58,43,15,34747.8490937856,"mid","D"
4430,166,59,107,236752.376918602,"big","D"
4431,234,209,25,63578.600094483,"big","D"
4432,8,4,4,7078.30191308121,"small","D"
4433,56,22,34,53325.9858627569,"mid","D"
4434,145,80,65,150411.647887058,"big","D"
4435,8,0,8,23003.8493660679,"small","D"
4436,117,84,33,67703.445793871,"big","D"
4437,72,41,31,74426.2666164057,"mid","D"
4438,28,16,12,23212.242305895,"mid","D"
4439,32,24,8,36274.2863324252,"mid","D"
4440,50,25,25,63198.2022125347,"mid","D"
4441,107,52,55,136040.670788934,"big","D"
4442,41,22,19,17453.8267717946,"mid","D"
4443,53,23,30,45969.1928085188,"mid","D"
4444,44,12,32,50738.7608260344,"mid","D"
4445,26,23,3,29072.4821895391,"mid","D"
4446,2,2,0,682.545779899804,"small","D"
4447,117,59,58,257701.391009974,"big","D"
4448,36,19,17,33795.8744946419,"mid","D"
4449,158,124,34,202391.79671988,"big","D"
4450,6,3,3,4670.23880709936,"small","D"
4451,116,48,68,18743.7456091157,"big","D"
4452,73,23,50,171003.489258121,"mid","D"
4453,46,38,8,31277.4781046084,"mid","D"
4454,5,3,2,5370.60474452401,"small","D"
4455,61,14,47,140031.366337014,"mid","D"
4456,57,17,40,17394.7515711081,"mid","D"
4457,41,41,0,18295.8486771582,"mid","D"
4458,51,25,26,129733.47625344,"mid","D"
4459,105,2,103,27512.2440531739,"big","D"
4460,212,18,194,63381.3443127913,"big","D"
4461,116,32,84,126592.047447529,"big","D"
4462,237,8,229,25563.8024766704,"big","D"
4463,59,40,19,79753.173265313,"mid","D"
4464,94,63,31,56053.5699890545,"mid","D"
4465,62,9,53,142733.339542308,"mid","D"
4466,21,16,5,3154.53103540576,"mid","D"
4467,16,11,5,25342.2583217375,"mid","D"
4468,167,52,115,313928.773440075,"big","D"
4469,35,24,11,3000.50353371261,"mid","D"
4470,60,33,27,29786.4207565927,"mid","D"
4471,44,36,8,82285.7106499458,"mid","D"
4472,51,32,19,34133.8732142215,"mid","D"
4473,32,0,32,15018.2743271902,"mid","D"
4474,84,31,53,28474.866099037,"mid","D"
4475,58,16,42,6250.41289557417,"mid","D"
4476,31,3,28,31916.6187650703,"mid","D"
4477,15,2,13,10609.7437786804,"mid","D"
4478,69,12,57,165319.446864131,"mid","D"
4479,14,9,5,12556.2248659069,"mid","D"
4480,104,66,38,95097.7344183987,"big","D"
4481,52,36,16,87411.5239487077,"mid","D"
4482,51,5,46,124350.819008711,"mid","D"
4483,18,3,15,9927.11920171761,"mid","D"
4484,208,39,169,172462.227416343,"big","D"
4485,95,65,30,23425.3480799302,"mid","D"
4486,39,7,32,51818.9379866151,"mid","D"
4487,26,18,8,29321.4611191831,"mid","D"
4488,44,40,4,69284.2038706417,"mid","D"
4489,74,51,23,74105.9365707402,"mid","D"
4490,20,8,12,16657.9456745605,"mid","D"
4491,122,64,58,228486.594311251,"big","D"
4492,3,1,2,2352.41616226307,"small","D"
4493,117,95,22,83796.6920548061,"big","D"
4494,32,25,7,15593.9642045705,"mid","D"
4495,115,65,50,168478.537674896,"big","D"
4496,50,31,19,3686.5743412466,"mid","D"
4497,181,145,36,253252.289776429,"big","D"
4498,125,21,104,309647.503386515,"big","D"
4499,255,23,232,331161.091513185,"big","D"
4500,114,9,105,230798.281711596,"big","D"
4501,20,13,7,40921.8122214572,"mid","D"
4502,34,31,3,57301.9266339443,"mid","D"
4503,53,9,44,102344.533349887,"mid","D"
4504,222,199,23,362921.487375118,"big","D"
4505,97,32,65,138093.952812489,"mid","D"
4506,95,67,28,208996.29502128,"mid","D"
4507,134,66,68,192628.085372748,"big","D"
4508,86,47,39,38768.59091825,"mid","D"
4509,61,29,32,31325.853630538,"mid","D"
4510,24,5,19,13829.0560537325,"mid","D"
4511,113,63,50,79064.3797366909,"big","D"
4512,27,9,18,25588.7438478546,"mid","D"
4513,61,1,60,49229.5283427076,"mid","D"
4514,223,207,16,166907.049967294,"big","D"
4515,35,10,25,53105.6725221155,"mid","D"
4516,24,12,12,78156.0772523925,"mid","D"
4517,164,154,10,485081.213355798,"big","D"
4518,185,50,135,209906.149377674,"big","D"
4519,5,2,3,7956.03842312323,"small","D"
4520,164,118,46,24949.8083491538,"big","D"
4521,39,26,13,45026.9941230875,"mid","D"
4522,98,53,45,186642.482539139,"mid","D"
4523,84,1,83,101496.669369943,"mid","D"
4524,158,126,32,304604.430468897,"big","D"
4525,185,49,136,161235.05576656,"big","D"
4526,204,111,93,135973.371180917,"big","D"
4527,20,2,18,20624.6783881702,"mid","D"
4528,223,143,80,458428.006910845,"big","D"
4529,135,72,63,363820.249543501,"big","D"
4530,71,15,56,623.261258289832,"mid","D"
4531,105,75,30,231445.978440282,"big","D"
4532,86,26,60,47052.2524899727,"mid","D"
4533,75,32,43,75115.140752604,"mid","D"
4534,8,3,5,9757.64982205621,"small","D"
4535,82,17,65,107087.066442828,"mid","D"
4536,240,144,96,357626.36052887,"big","D"
4537,53,13,40,62149.9022339661,"mid","D"
4538,13,11,2,22390.2524977522,"mid","D"
4539,53,34,19,20276.4654451138,"mid","D"
4540,132,89,43,190932.391746171,"big","D"
4541,107,107,0,33633.6117441528,"big","D"
4542,133,97,36,60183.5749361375,"big","D"
4543,129,108,21,93900.0988988468,"big","D"
4544,84,66,18,11188.0322271099,"mid","D"
4545,35,18,17,31929.9509598102,"mid","D"
4546,107,89,18,160679.615720771,"big","D"
4547,58,4,54,73197.5184598856,"mid","D"
4548,122,68,54,73183.5885637932,"big","D"
4549,111,8,103,285314.439671903,"big","D"
4550,161,126,35,68708.8857015451,"big","D"
4551,72,52,20,146998.851477841,"mid","D"
4552,126,12,114,205256.250829204,"big","D"
4553,45,6,39,36246.8630676711,"mid","D"
4554,228,132,96,247196.127436135,"big","D"
4555,151,29,122,134722.24409165,"big","D"
4556,3,1,2,3105.9184574219,"small","D"
4557,57,42,15,54716.4018515508,"mid","D"
4558,19,17,2,15251.1295225581,"mid","D"
4559,126,3,123,242064.590641413,"big","D"
4560,83,34,49,122519.920663378,"mid","D"
4561,28,9,19,32206.4996012773,"mid","D"
4562,77,57,20,20420.4708592006,"mid","D"
4563,160,67,93,422955.515142519,"big","D"
4564,118,39,79,34090.0280822374,"big","D"
4565,7,3,4,8243.57837667958,"small","D"
4566,50,11,39,8696.30415436222,"mid","D"
4567,56,12,44,41629.6044173237,"mid","D"
4568,32,20,12,7175.77866608227,"mid","D"
4569,176,141,35,95934.9554544601,"big","D"
4570,76,64,12,40854.1595856053,"mid","D"
4571,74,43,31,9184.76809015824,"mid","D"
4572,99,38,61,166079.218898777,"mid","D"
4573,20,11,9,28120.8859126404,"mid","D"
4574,2,1,1,4126.75584286158,"small","D"
4575,34,8,26,40520.6281529097,"mid","D"
4576,260,86,174,618268.939720963,"big","D"
4577,2,0,2,3583.74359874109,"small","D"
4578,23,4,19,30375.8469611477,"mid","D"
4579,288,168,120,372662.709114091,"big","D"
4580,187,142,45,129066.628980665,"big","D"
4581,3,1,2,4328.36490744782,"small","D"
4582,20,13,7,19230.0658059144,"mid","D"
4583,41,17,24,102671.373395032,"mid","D"
4584,131,44,87,352717.290035878,"big","D"
4585,52,48,4,73492.785324855,"mid","D"
4586,77,58,19,153058.623790012,"mid","D"
4587,160,74,86,147350.96688501,"big","D"
4588,6,5,1,10044.123346479,"small","D"
4589,32,17,15,87497.541542087,"mid","D"
4590,10,8,2,19255.6457763584,"small","D"
4591,22,5,17,29326.3057422764,"mid","D"
4592,19,1,18,23821.316499494,"mid","D"
4593,2,2,0,692.376958816677,"small","D"
4594,91,45,46,138754.831043081,"mid","D"
4595,101,36,65,27301.35653661,"big","D"
4596,64,62,2,115856.84725512,"mid","D"
4597,140,50,90,101134.187274414,"big","D"
4598,179,134,45,488040.667351219,"big","D"
4599,108,86,22,41076.4991338252,"big","D"
4600,78,3,75,233116.82974638,"mid","D"
4601,65,44,21,151068.170862542,"mid","D"
4602,2,1,1,1269.82542256752,"small","D"
4603,60,32,28,31253.7845527296,"mid","D"
4604,71,48,23,58340.0785758023,"mid","D"
4605,83,34,49,118260.974658036,"mid","D"
4606,2,0,2,3397.37902256805,"small","D"
4607,52,47,5,146855.709189179,"mid","D"
4608,131,130,1,160756.393030177,"big","D"
4609,47,45,2,107002.425590041,"mid","D"
4610,99,89,10,113264.162905029,"mid","D"
4611,22,6,16,45809.9605598048,"mid","D"
4612,76,4,72,186734.82442161,"mid","D"
4613,22,14,8,2466.50601093999,"mid","D"
4614,74,13,61,15462.621079221,"mid","D"
4615,8,6,2,2164.54210090626,"small","D"
4616,13,5,8,19346.5135532279,"mid","D"
4617,117,52,65,222429.734610355,"big","D"
4618,129,9,120,181322.707553023,"big","D"
4619,3,0,3,5149.30097466686,"small","D"
4620,21,2,19,1267.41052056182,"mid","D"
4621,154,120,34,149297.020584446,"big","D"
4622,93,54,39,104170.499208891,"mid","D"
4623,22,21,1,45328.7674885595,"mid","D"
4624,200,182,18,364457.207042759,"big","D"
4625,71,63,8,9873.38421890298,"mid","D"
4626,72,48,24,221605.832281335,"mid","D"
4627,87,67,20,39455.9142922336,"mid","D"
4628,219,87,132,138037.13820397,"big","D"
4629,102,52,50,73555.858275472,"big","D"
4630,7,6,1,2043.16470835833,"small","D"
4631,115,12,103,82390.1070897246,"big","D"
4632,124,33,91,266930.24287457,"big","D"
4633,105,6,99,146266.686608916,"big","D"
4634,70,36,34,79240.6998595027,"mid","D"
4635,131,7,124,182135.524901811,"big","D"
4636,7,2,5,2741.35678261163,"small","D"
4637,43,1,42,68990.4070613449,"mid","D"
4638,2,2,0,2246.68933547749,"small","D"
4639,60,5,55,87260.6238781376,"mid","D"
4640,90,39,51,133252.861299212,"mid","D"
4641,21,16,5,4076.50780187377,"mid","D"
4642,20,17,3,13155.4192416579,"mid","D"
4643,11,1,10,14192.3795851422,"mid","D"
4644,31,7,24,60542.678080135,"mid","D"
4645,16,1,15,20778.741483347,"mid","D"
4646,188,157,31,411232.734035484,"big","D"
4647,214,38,176,379270.085238375,"big","D"
4648,188,177,11,404708.455033203,"big","D"
4649,7,3,4,2361.4632628671,"small","D"
4650,132,108,24,271864.347680154,"big","D"
4651,245,74,171,379392.52815987,"big","D"
4652,37,13,24,12400.1993698333,"mid","D"
4653,4,0,4,5569.8249817135,"small","D"
4654,124,87,37,139358.670446989,"big","D"
4655,171,35,136,53487.46386274,"big","D"
4656,60,10,50,98528.4962746502,"mid","D"
4657,34,10,24,8312.2905651379,"mid","D"
4658,21,20,1,20967.7801563865,"mid","D"
4659,101,12,89,88880.9489047744,"big","D"
4660,160,85,75,257315.703406806,"big","D"
4661,187,63,124,376089.644658116,"big","D"
4662,14,3,11,14374.1779414766,"mid","D"
4663,3,1,2,9371.34569738136,"small","D"
4664,51,36,15,99507.0853438454,"mid","D"
4665,123,41,82,79123.6819130937,"big","D"
4666,109,54,55,209119.382212175,"big","D"
4667,72,21,51,63408.2208981654,"mid","D"
4668,7,0,7,14438.0933982544,"small","D"
4669,1,0,1,1064.31986296941,"small","D"
4670,36,33,3,39674.1788460445,"mid","D"
4671,48,25,23,13913.4772918721,"mid","D"
4672,131,42,89,43749.5862373316,"big","D"
4673,137,68,69,22344.2099603342,"big","D"
4674,67,27,40,119835.066485311,"mid","D"
4675,28,20,8,307.002428418433,"mid","D"
4676,12,1,11,30269.9774795207,"mid","D"
4677,25,3,22,68839.0352513012,"mid","D"
4678,83,38,45,14246.4877593193,"mid","D"
4679,48,12,36,23463.177078124,"mid","D"
4680,192,143,49,170359.026650851,"big","D"
4681,173,43,130,282129.554909041,"big","D"
4682,2,0,2,756.724086991637,"small","D"
4683,97,46,51,130501.733884126,"mid","D"
4684,78,66,12,66021.7909080543,"mid","D"
4685,8,2,6,6978.18663869196,"small","D"
4686,27,7,20,32755.8306874672,"mid","D"
4687,38,26,12,31497.2099154755,"mid","D"
4688,178,95,83,381921.274057286,"big","D"
4689,38,27,11,25998.4057518637,"mid","D"
4690,89,39,50,103713.509436198,"mid","D"
4691,81,73,8,110145.932717278,"mid","D"
4692,145,29,116,42231.5565346365,"big","D"
4693,10,10,0,15324.1442873061,"small","D"
4694,71,2,69,58425.2030668972,"mid","D"
4695,156,92,64,250968.735495016,"big","D"
4696,177,135,42,429326.162232636,"big","D"
4697,72,60,12,67444.2209020604,"mid","D"
4698,159,59,100,290578.991244048,"big","D"
4699,89,84,5,253864.473574682,"mid","D"
4700,88,63,25,142346.171650426,"mid","D"
4701,8,6,2,1703.51915561534,"small","D"
4702,163,63,100,66705.2647656195,"big","D"
4703,161,120,41,42595.0470417162,"big","D"
4704,70,36,34,65214.5986531169,"mid","D"
4705,3,3,0,5310.27554767199,"small","D"
4706,61,19,42,43991.9123430729,"mid","D"
4707,113,33,80,129523.53915045,"big","D"
4708,9,4,5,690.83187885553,"small","D"
4709,86,22,64,67516.1383565563,"mid","D"
4710,50,32,18,22144.9643444864,"mid","D"
4711,186,99,87,133704.011945296,"big","D"
4712,59,53,6,141127.943728037,"mid","D"
4713,94,33,61,23709.315528382,"mid","D"
4714,54,17,37,4715.65701281324,"mid","D"
4715,197,185,12,160851.931911849,"big","D"
4716,113,21,92,15164.2775298863,"big","D"
4717,126,76,50,17261.8533462838,"big","D"
4718,23,8,15,33282.6598984969,"mid","D"
4719,10,2,8,26271.7654184411,"small","D"
4720,49,38,11,54577.0556605787,"mid","D"
4721,95,27,68,216463.680167335,"mid","D"
4722,112,55,57,205140.774978217,"big","D"
4723,54,40,14,4206.88428468026,"mid","D"
4724,219,34,185,476371.615049046,"big","D"
4725,27,15,12,114398.993950508,"mid","D"
4726,82,5,77,43338.8161583819,"mid","D"
4727,73,29,44,3260.65802978715,"mid","D"
4728,103,84,19,149430.219275981,"big","D"
4729,108,2,106,195412.709068181,"big","D"
4730,72,39,33,41397.7711589334,"mid","D"
4731,99,2,97,135992.686470101,"mid","D"
4732,35,19,16,44768.3884529069,"mid","D"
4733,22,1,21,20121.031217885,"mid","D"
4734,99,28,71,22248.3311688843,"mid","D"
4735,22,13,9,12094.5975308632,"mid","D"
4736,73,5,68,143425.871042276,"mid","D"
4737,22,15,7,31441.7331228821,"mid","D"
4738,95,42,53,181496.960783905,"mid","D"
4739,125,114,11,199044.51564346,"big","D"
4740,128,79,49,270099.083838433,"big","D"
4741,26,1,25,7951.99405593324,"mid","D"
4742,42,2,40,29600.8192503556,"mid","D"
4743,37,24,13,41354.9327651722,"mid","D"
4744,129,50,79,1164.87307075865,"big","D"
4745,74,53,21,145348.630602122,"mid","D"
4746,63,9,54,134269.99286367,"mid","D"
4747,55,22,33,61926.8963649933,"mid","D"
4748,35,34,1,73123.0829912778,"mid","D"
4749,138,37,101,101280.319300962,"big","D"
4750,94,37,57,21583.293399503,"mid","D"
4751,74,65,9,181892.006739142,"mid","D"
4752,119,46,73,165784.038689061,"big","D"
4753,48,11,37,20996.0263221067,"mid","D"
4754,62,14,48,169179.735750704,"mid","D"
4755,42,40,2,58744.1200950032,"mid","D"
4756,141,36,105,130594.778130609,"big","D"
4757,100,34,66,116117.275282331,"mid","D"
4758,2,1,1,7312.29033281694,"small","D"
4759,147,118,29,38826.9693633553,"big","D"
4760,108,103,5,177141.734490188,"big","D"
4761,48,6,42,81212.078438027,"mid","D"
4762,26,25,1,33362.2206702522,"mid","D"
4763,51,24,27,97438.0896582551,"mid","D"
4764,69,4,65,3645.28588114864,"mid","D"
4765,19,6,13,20978.0007215602,"mid","D"
4766,125,61,64,3088.45460153621,"big","D"
4767,82,57,25,60259.4991236663,"mid","D"
4768,96,56,40,194770.071277981,"mid","D"
4769,65,18,47,66332.9469940019,"mid","D"
4770,20,3,17,32907.587796703,"mid","D"
4771,14,4,10,24957.6072735964,"mid","D"
4772,25,19,6,45297.5541024487,"mid","D"
4773,60,6,54,135324.134406103,"mid","D"
4774,1,1,0,539.776793904226,"small","D"
4775,114,110,4,135553.257298791,"big","D"
4776,93,39,54,10259.8638436883,"mid","D"
4777,9,0,9,365.155531461131,"small","D"
4778,64,23,41,73241.563334086,"mid","D"
4779,27,6,21,33038.3137402589,"mid","D"
4780,33,18,15,59705.7105143631,"mid","D"
4781,80,72,8,194540.922015192,"mid","D"
4782,125,103,22,66393.4833519786,"big","D"
4783,95,34,61,147698.607316926,"mid","D"
4784,157,90,67,41290.9516182087,"big","D"
4785,51,13,38,3795.09361114601,"mid","D"
4786,132,61,71,294465.6602708,"big","D"
4787,10,5,5,20317.117983977,"small","D"
4788,153,61,92,82350.3520575088,"big","D"
4789,90,56,34,90819.0747035167,"mid","D"
4790,2,1,1,2063.7350205509,"small","D"
4791,7,3,4,11408.9986574016,"small","D"
4792,10,3,7,22561.7902286158,"small","D"
4793,46,10,36,42399.3609122904,"mid","D"
4794,68,17,51,130203.461238977,"mid","D"
4795,95,68,27,135274.43112017,"mid","D"
4796,83,5,78,29545.7673734359,"mid","D"
4797,99,51,48,147733.320432976,"mid","D"
4798,211,126,85,80985.0495660742,"big","D"
4799,75,2,73,115013.722404011,"mid","D"
4800,228,226,2,41527.1590611205,"big","D"
4801,60,5,55,101738.038821387,"mid","D"
4802,81,52,29,93792.4210355095,"mid","D"
4803,64,10,54,78778.8329612315,"mid","D"
4804,52,2,50,44714.0518250348,"mid","D"
4805,48,43,5,83760.1626506715,"mid","D"
4806,144,85,59,71665.4828501354,"big","D"
4807,4,2,2,2461.73908251178,"small","D"
4808,21,2,19,36420.9221893672,"mid","D"
4809,10,1,9,34582.6848446139,"small","D"
4810,2,1,1,1981.98639169038,"small","D"
4811,165,12,153,174798.85105719,"big","D"
4812,210,141,69,133226.707746624,"big","D"
4813,13,10,3,30922.614074598,"mid","D"
4814,130,120,10,119376.47802479,"big","D"
4815,222,190,32,291217.557907074,"big","D"
4816,77,74,3,58523.092618273,"mid","D"
4817,89,49,40,202595.079978673,"mid","D"
4818,28,22,6,7399.28998132019,"mid","D"
4819,133,13,120,229476.326857071,"big","D"
4820,62,0,62,43394.0245018441,"mid","D"
4821,54,25,29,94243.344120393,"mid","D"
4822,90,37,53,91967.2209636151,"mid","D"
4823,108,48,60,31994.4994681433,"big","D"
4824,35,21,14,51991.7359859188,"mid","D"
4825,180,32,148,29164.640985993,"big","D"
4826,369,281,88,808041.573140146,"big","D"
4827,17,12,5,32049.5514525369,"mid","D"
4828,136,135,1,391398.841058609,"big","D"
4829,44,11,33,156366.483162956,"mid","D"
4830,122,29,93,224069.537230575,"big","D"
4831,174,40,134,153491.440509204,"big","D"
4832,62,21,41,67821.3279149406,"mid","D"
4833,297,287,10,102342.194067194,"big","D"
4834,77,36,41,109002.402811557,"mid","D"
4835,8,8,0,9499.47946606599,"small","D"
4836,93,14,79,48372.9250047396,"mid","D"
4837,77,20,57,21543.2769264913,"mid","D"
4838,25,7,18,21262.5264417136,"mid","D"
4839,95,1,94,145787.622620694,"mid","D"
4840,6,3,3,592.860850474439,"small","D"
4841,65,39,26,109507.592951534,"mid","D"
4842,101,100,1,149540.740123598,"big","D"
4843,41,28,13,52727.546500111,"mid","D"
4844,52,21,31,11604.5172971582,"mid","D"
4845,62,15,47,5361.53820515979,"mid","D"
4846,73,22,51,137984.823613829,"mid","D"
4847,163,150,13,12053.8199539769,"big","D"
4848,51,39,12,27864.0324588162,"mid","D"
4849,32,18,14,37543.1094894358,"mid","D"
4850,3,2,1,2307.63295627744,"small","D"
4851,258,174,84,509845.789733938,"big","D"
4852,30,18,12,32691.9102829183,"mid","D"
4853,36,31,5,28211.9835265327,"mid","D"
4854,60,31,29,13448.4030139978,"mid","D"
4855,116,46,70,60821.5893210264,"big","D"
4856,124,59,65,125822.133229175,"big","D"
4857,52,1,51,7253.63477361423,"mid","D"
4858,60,50,10,94437.6845492014,"mid","D"
4859,264,196,68,646087.546597936,"big","D"
4860,100,9,91,269317.453980818,"mid","D"
4861,52,43,9,24112.3951646391,"mid","D"
4862,5,1,4,4842.58993361471,"small","D"
4863,36,34,2,25807.3477411488,"mid","D"
4864,16,5,11,26065.6457531299,"mid","D"
4865,56,25,31,43316.1407566336,"mid","D"
4866,3,3,0,4443.02883972851,"small","D"
4867,74,60,14,68694.6061471662,"mid","D"
4868,156,8,148,419884.223355969,"big","D"
4869,63,11,52,36965.7799400918,"mid","D"
4870,77,15,62,149507.906725292,"mid","D"
4871,42,30,12,43254.7956250057,"mid","D"
4872,138,11,127,51911.6853699983,"big","D"
4873,12,4,8,15916.789313072,"mid","D"
4874,214,112,102,291781.568689955,"big","D"
4875,84,0,84,64499.9594058544,"mid","D"
4876,48,25,23,45952.7682868335,"mid","D"
4877,86,66,20,261054.699175525,"mid","D"
4878,17,10,7,6746.86931976003,"mid","D"
4879,166,152,14,205782.034155037,"big","D"
4880,68,25,43,46980.3644151382,"mid","D"
4881,12,10,2,4285.83046832338,"mid","D"
4882,4,3,1,9727.01225300702,"small","D"
4883,18,10,8,41022.7123029312,"mid","D"
4884,43,6,37,33455.9129207798,"mid","D"
4885,12,10,2,6580.75161795274,"mid","D"
4886,61,41,20,70891.4179846989,"mid","D"
4887,94,1,93,18313.7482407596,"mid","D"
4888,17,16,1,6054.91386548003,"mid","D"
4889,34,21,13,86358.1673028236,"mid","D"
4890,130,85,45,275115.891543531,"big","D"
4891,73,38,35,124066.142715622,"mid","D"
4892,121,93,28,174237.190846322,"big","D"
4893,76,47,29,139125.604964083,"mid","D"
4894,95,88,7,67929.1722619933,"mid","D"
4895,26,23,3,57882.7028415386,"mid","D"
4896,135,53,82,84981.8997650173,"big","D"
4897,78,46,32,247755.431862286,"mid","D"
4898,151,32,119,52705.1087004428,"big","D"
4899,68,19,49,1276.76039021819,"mid","D"
4900,98,93,5,213264.835754997,"mid","D"
4901,152,59,93,299182.184194962,"big","D"
4902,56,14,42,66821.3919704115,"mid","D"
4903,43,1,42,67441.9031585182,"mid","D"
4904,39,27,12,16198.7295767563,"mid","D"
4905,39,20,19,32987.9507893198,"mid","D"
4906,8,7,1,301.737165812636,"small","D"
4907,135,14,121,279636.105944453,"big","D"
4908,131,129,2,121964.998368363,"big","D"
4909,184,128,56,66027.2328081177,"big","D"
4910,72,7,65,74719.5191605086,"mid","D"
4911,85,24,61,143046.047613707,"mid","D"
4912,41,23,18,31244.7429765598,"mid","D"
4913,65,52,13,66573.3670697609,"mid","D"
4914,75,1,74,60604.0260099039,"mid","D"
4915,83,45,38,12828.9455916688,"mid","D"
4916,67,67,0,66718.8805537941,"mid","D"
4917,54,49,5,67672.9963886642,"mid","D"
4918,4,3,1,6410.59539862094,"small","D"
4919,83,10,73,39862.5337821738,"mid","D"
4920,75,72,3,14340.3263012639,"mid","D"
4921,79,10,69,104783.507395766,"mid","D"
4922,108,100,8,160294.336970619,"big","D"
4923,28,5,23,25988.0767882139,"mid","D"
4924,142,8,134,105609.841146234,"big","D"
4925,22,3,19,38580.539274778,"mid","D"
4926,55,44,11,49671.5112988273,"mid","D"
4927,22,2,20,17662.2231135263,"mid","D"
4928,4,3,1,9178.13032969662,"small","D"
4929,159,83,76,26333.7910649219,"big","D"
4930,68,22,46,117795.929474844,"mid","D"
4931,8,1,7,16151.4205020914,"small","D"
4932,138,30,108,321193.015560012,"big","D"
4933,149,42,107,91827.4248629896,"big","D"
4934,275,235,40,6349.98170807776,"big","D"
4935,65,62,3,16921.2310791258,"mid","D"
4936,142,58,84,138558.919243717,"big","D"
4937,36,7,29,44769.32874454,"mid","D"
4938,140,48,92,135483.001316841,"big","D"
4939,148,34,114,1367.62017522685,"big","D"
4940,39,22,17,42519.4581445362,"mid","D"
4941,14,12,2,21576.1076036008,"mid","D"
4942,82,66,16,156020.530149065,"mid","D"
4943,37,8,29,12470.5799676383,"mid","D"
4944,6,5,1,3298.91654717571,"small","D"
4945,52,14,38,83497.3149875963,"mid","D"
4946,77,18,59,162160.584286497,"mid","D"
4947,27,21,6,4342.81537416083,"mid","D"
4948,154,90,64,173288.903765694,"big","D"
4949,52,32,20,7888.81992303625,"mid","D"
4950,176,1,175,40527.7205497248,"big","D"
4951,216,95,121,564229.401440082,"big","D"
4952,79,44,35,8576.97251048087,"mid","D"
4953,10,1,9,9617.60261817631,"small","D"
4954,134,72,62,54546.6454010529,"big","D"
4955,66,9,57,2182.72638690729,"mid","D"
4956,14,3,11,33772.1546259646,"mid","D"
4957,76,2,74,164409.292535817,"mid","D"
4958,28,3,25,75811.3593932001,"mid","D"
4959,41,11,30,3568.97151932304,"mid","D"
4960,29,18,11,67320.548568153,"mid","D"
4961,23,17,6,59646.6911094911,"mid","D"
4962,69,43,26,125584.842217941,"mid","D"
4963,97,85,12,154777.83750331,"mid","D"
4964,9,7,2,17292.589551844,"small","D"
4965,56,5,51,1349.59768505152,"mid","D"
4966,25,12,13,13052.0505760968,"mid","D"
4967,65,19,46,38834.0056900768,"mid","D"
4968,161,60,101,187483.619318996,"big","D"
4969,117,104,13,119543.178845927,"big","D"
4970,38,15,23,30650.0070434947,"mid","D"
4971,42,34,8,49000.2539890585,"mid","D"
4972,30,29,1,80632.7860037117,"mid","D"
4973,167,117,50,106050.566763763,"big","D"
4974,198,63,135,227215.584237723,"big","D"
4975,58,54,4,25746.7070689342,"mid","D"
4976,98,1,97,11656.027760637,"mid","D"
4977,70,4,66,45045.287930386,"mid","D"
4978,102,57,45,62258.1143650855,"big","D"
4979,29,1,28,36714.4444484341,"mid","D"
4980,61,7,54,2269.73282682137,"mid","D"
4981,89,64,25,140887.270026761,"mid","D"
4982,39,5,34,29618.8267471281,"mid","D"
4983,56,11,45,10647.8649396849,"mid","D"
4984,80,29,51,85896.9777013472,"mid","D"
4985,12,12,0,18711.6652744955,"mid","D"
4986,51,27,24,11816.3125718728,"mid","D"
4987,280,98,182,360980.374073276,"big","D"
4988,3,1,2,2897.02009784572,"small","D"
4989,4,1,3,6701.86000026734,"small","D"
4990,7,3,4,5270.29656000152,"small","D"
4991,96,67,29,24018.3147466133,"mid","D"
4992,47,43,4,33941.7391716507,"mid","D"
4993,72,9,63,123380.799548267,"mid","D"
4994,110,26,84,67021.760640113,"big","D"
4995,235,70,165,27294.0954408641,"big","D"
4996,96,78,18,158379.379024788,"mid","D"
4997,19,11,8,25319.7805023622,"mid","D"
4998,53,27,26,119645.127271803,"mid","D"
4999,23,4,19,70981.9773851467,"mid","D"
5000,163,126,37,19613.613032842,"big","D"
5001,81,63,18,126597.686223668,"mid","D"
5002,30,3,27,2088.87898939773,"mid","D"
5003,14,10,4,2558.93150671404,"mid","D"
5004,53,29,24,74215.678416294,"mid","D"
5005,288,216,72,537259.060732668,"big","D"
5006,111,57,54,1142.78804397379,"big","D"
5007,35,28,7,1547.09971238438,"mid","D"
5008,102,32,70,15067.011331921,"big","D"
5009,51,39,12,74095.1681496523,"mid","D"
5010,132,70,62,26370.7062581979,"big","D"
5011,113,86,27,118374.368029652,"big","D"
5012,173,130,43,273032.73171953,"big","D"
5013,49,20,29,8044.16282383424,"mid","D"
5014,2,2,0,3122.47884921215,"small","D"
5015,30,9,21,16595.0080561879,"mid","D"
5016,1,1,0,123.179290285298,"small","D"
5017,9,2,7,11310.1213182724,"small","D"
5018,102,83,19,130273.794621737,"big","D"
5019,142,16,126,288597.359071513,"big","D"
5020,65,25,40,26958.5881662776,"mid","D"
5021,6,4,2,12910.315384747,"small","D"
5022,46,1,45,137789.289481137,"mid","D"
5023,66,35,31,51840.8959741428,"mid","D"
5024,8,1,7,31878.1381189885,"small","D"
5025,52,29,23,157920.458043911,"mid","D"
5026,85,28,57,54060.3164563085,"mid","D"
5027,16,9,7,20815.6373183585,"mid","D"
5028,85,53,32,135507.923867537,"mid","D"
5029,184,183,1,76218.429193552,"big","D"
5030,21,7,14,27006.7730681058,"mid","D"
5031,76,67,9,39303.118851623,"mid","D"
5032,100,4,96,16237.0850480394,"mid","D"
5033,30,4,26,43693.0969708365,"mid","D"
5034,164,34,130,193604.00211143,"big","D"
5035,171,75,96,335970.891765436,"big","D"
5036,2,2,0,1585.45706500281,"small","D"
5037,99,13,86,257136.361356036,"mid","D"
5038,126,67,59,320904.738994314,"big","D"
5039,170,88,82,287777.490280232,"big","D"
5040,87,16,71,10307.9823762374,"mid","D"
5041,32,10,22,80322.5523717181,"mid","D"
5042,161,83,78,96995.2694109521,"big","D"
5043,174,74,100,296837.03549144,"big","D"
5044,83,72,11,22248.2547879143,"mid","D"
5045,105,7,98,120413.140051226,"big","D"
5046,84,71,13,52221.5997354912,"mid","D"
5047,8,3,5,10901.1305443362,"small","D"
5048,62,54,8,50042.7779038699,"mid","D"
5049,10,7,3,7801.77251775258,"small","D"
5050,79,75,4,33211.5168298248,"mid","D"
5051,114,3,111,89133.9499797451,"big","D"
5052,47,6,41,34711.9605000649,"mid","D"
5053,20,7,13,28134.0284271917,"mid","D"
5054,82,14,68,18585.4759913339,"mid","D"
5055,48,29,19,23584.504676458,"mid","D"
5056,41,30,11,100320.624637923,"mid","D"
5057,176,74,102,188962.119985893,"big","D"
5058,85,70,15,23885.6884324112,"mid","D"
5059,74,48,26,167983.046084485,"mid","D"
5060,146,145,1,265718.492667055,"big","D"
5061,52,38,14,53817.4641893592,"mid","D"
5062,96,4,92,190505.342544421,"mid","D"
5063,38,34,4,71871.1057440518,"mid","D"
5064,64,7,57,102087.08606177,"mid","D"
5065,39,38,1,8203.61346111394,"mid","D"
5066,16,11,5,38196.7573150761,"mid","D"
5067,41,3,38,38988.8069817756,"mid","D"
5068,110,17,93,2002.01277824636,"big","D"
5069,110,83,27,63253.6679169399,"big","D"
5070,46,23,23,15954.8861264782,"mid","D"
5071,244,102,142,552416.11499182,"big","D"
5072,190,136,54,521066.161969542,"big","D"
5073,101,91,10,295644.345868973,"big","D"
5074,53,48,5,18530.3570771746,"mid","D"
5075,19,9,10,29523.8034991732,"mid","D"
5076,57,1,56,128429.06030625,"mid","D"
5077,88,63,25,119283.855373368,"mid","D"
5078,103,77,26,55280.8735436159,"big","D"
5079,40,13,27,9769.88832613623,"mid","D"
5080,73,8,65,48318.7843163374,"mid","D"
5081,58,15,43,20420.9007335572,"mid","D"
5082,7,3,4,23480.0872076973,"small","D"
5083,85,25,60,63551.3484990399,"mid","D"
5084,192,170,22,433656.277335497,"big","D"
5085,111,73,38,199627.613449743,"big","D"
5086,58,28,30,94870.4197833792,"mid","D"
5087,147,103,44,322605.828412212,"big","D"
5088,185,165,20,251027.435512888,"big","D"
5089,35,33,2,62073.5532303582,"mid","D"
5090,31,9,22,19083.4503877467,"mid","D"
5091,12,11,1,3761.94316761607,"mid","D"
5092,23,13,10,49560.2670690213,"mid","D"
5093,27,24,3,5991.61069183026,"mid","D"
5094,34,6,28,24986.2869578185,"mid","D"
5095,15,8,7,7134.91576163712,"mid","D"
5096,55,47,8,171607.58743734,"mid","D"
5097,144,92,52,137237.719007401,"big","D"
5098,87,75,12,95645.8592252581,"mid","D"
5099,126,125,1,51526.4216518637,"big","D"
5100,103,30,73,356827.554728355,"big","D"
5101,113,15,98,172071.71516142,"big","D"
5102,126,72,54,143349.450353366,"big","D"
5103,62,35,27,118305.039589156,"mid","D"
5104,24,7,17,17211.9215352693,"mid","D"
5105,1,1,0,185.393416854753,"small","D"
5106,112,6,106,70769.1477731411,"big","D"
5107,65,12,53,124158.619185826,"mid","D"
5108,28,2,26,34161.4687062672,"mid","D"
5109,19,14,5,22916.1755031141,"mid","D"
5110,115,35,80,6770.25636062886,"big","D"
5111,205,5,200,57684.3545356527,"big","D"
5112,102,46,56,33310.1456410314,"big","D"
5113,102,44,58,109394.666533901,"big","D"
5114,104,36,68,104599.793950976,"big","D"
5115,59,3,56,60712.0825373012,"mid","D"
5116,114,14,100,267397.119290731,"big","D"
5117,8,4,4,6297.03844564305,"small","D"
5118,18,6,12,11280.3041899356,"mid","D"
5119,121,82,39,11353.7603787091,"big","D"
5120,91,38,53,22997.9392395866,"mid","D"
5121,174,164,10,123019.178070899,"big","D"
5122,151,116,35,52357.6544041396,"big","D"
5123,39,31,8,85536.9662227967,"mid","D"
5124,22,15,7,51060.3212453015,"mid","D"
5125,91,37,54,104951.915002328,"mid","D"
5126,59,13,46,157168.41374487,"mid","D"
5127,135,64,71,220027.778275087,"big","D"
5128,33,4,29,59135.2183370673,"mid","D"
5129,46,35,11,107990.243838228,"mid","D"
5130,137,65,72,377789.73657844,"big","D"
5131,164,121,43,49480.7749828202,"big","D"
5132,129,73,56,108078.124630029,"big","D"
5133,190,120,70,433700.434683639,"big","D"
5134,61,22,39,150628.534110452,"mid","D"
5135,25,8,17,9732.11621488503,"mid","D"
5136,93,11,82,12557.0727958323,"mid","D"
5137,38,29,9,42655.341434837,"mid","D"
5138,95,21,74,236822.581806208,"mid","D"
5139,78,64,14,5088.95731694789,"mid","D"
5140,77,8,69,76298.0989157863,"mid","D"
5141,147,66,81,158768.164998488,"big","D"
5142,6,6,0,6871.71700090899,"small","D"
5143,29,23,6,42300.3100844556,"mid","D"
5144,99,90,9,11693.4133273689,"mid","D"
5145,6,5,1,12878.9558806952,"small","D"
5146,8,5,3,17843.5240319869,"small","D"
5147,122,69,53,145399.428857098,"big","D"
5148,135,114,21,280821.053844043,"big","D"
5149,155,33,122,100497.365639789,"big","D"
5150,11,10,1,23048.185134212,"mid","D"
5151,121,54,67,232545.591288792,"big","D"
5152,53,46,7,74420.9224200958,"mid","D"
5153,115,107,8,156032.791037917,"big","D"
5154,149,84,65,291776.827098411,"big","D"
5155,70,24,46,13268.0454993021,"mid","D"
5156,172,2,170,6361.37477214207,"big","D"
5157,51,24,27,67877.0375581254,"mid","D"
5158,138,94,44,66045.7848090672,"big","D"
5159,17,13,4,21260.8208916043,"mid","D"
5160,81,36,45,64640.4184271146,"mid","D"
5161,160,0,160,81814.1458112988,"big","D"
5162,11,10,1,20306.7897086371,"mid","D"
5163,81,70,11,28076.6686824017,"mid","D"
5164,47,2,45,88989.8463631245,"mid","D"
5165,44,18,26,114904.658915547,"mid","D"
5166,118,80,38,6964.96160504498,"big","D"
5167,111,2,109,186202.450925564,"big","D"
5168,40,26,14,2815.1232811206,"mid","D"
5169,17,17,0,27668.6517454448,"mid","D"
5170,22,0,22,38455.4060450478,"mid","D"
5171,43,10,33,15405.0549048991,"mid","D"
5172,204,120,84,148095.904096293,"big","D"
5173,32,31,1,57429.418350931,"mid","D"
5174,6,2,4,5967.95444322404,"small","D"
5175,4,3,1,4536.95005972485,"small","D"
5176,10,2,8,7482.93361257851,"small","D"
5177,66,64,2,83567.144862139,"mid","D"
5178,19,17,2,32229.2023057893,"mid","D"
5179,29,15,14,49735.1013243296,"mid","D"
5180,60,59,1,89671.0853057447,"mid","D"
5181,249,97,152,443996.283770812,"big","D"
5182,83,5,78,41941.7075728347,"mid","D"
5183,184,115,69,125104.286486813,"big","D"
5184,48,14,34,11363.3945205185,"mid","D"
5185,24,4,20,27723.3069914848,"mid","D"
5186,18,5,13,17658.5276535217,"mid","D"
5187,24,16,8,33924.4218913087,"mid","D"
5188,101,101,0,41228.3988834267,"big","D"
5189,15,13,2,12559.2841430532,"mid","D"
5190,5,3,2,16144.8448198498,"small","D"
5191,45,21,24,97036.7824487639,"mid","D"
5192,36,3,33,52516.1380141161,"mid","D"
5193,111,104,7,116531.457912158,"big","D"
5194,177,37,140,212133.257393972,"big","D"
5195,134,89,45,244456.021740572,"big","D"
5196,47,13,34,8575.0854116846,"mid","D"
5197,205,140,65,184914.635547158,"big","D"
5198,199,192,7,62644.5087076328,"big","D"
5199,11,7,4,14773.4990337343,"mid","D"
5200,145,144,1,113548.601054395,"big","D"
5201,37,16,21,25269.6107662932,"mid","D"
5202,20,11,9,31204.367763118,"mid","D"
5203,148,101,47,17681.3144112606,"big","D"
5204,179,156,23,256611.011104451,"big","D"
5205,28,13,15,28784.4447735673,"mid","D"
5206,30,8,22,35462.6586035789,"mid","D"
5207,13,6,7,2856.10266534548,"mid","D"
5208,116,14,102,305720.479478669,"big","D"
5209,41,38,3,129220.493111612,"mid","D"
5210,5,2,3,8817.03172801824,"small","D"
5211,62,1,61,122628.343873203,"mid","D"
5212,195,163,32,308238.238752467,"big","D"
5213,17,6,11,26959.1289640218,"mid","D"
5214,156,103,53,248298.950502715,"big","D"
5215,66,34,32,107868.208204373,"mid","D"
5216,2,1,1,292.534167182597,"small","D"
5217,139,37,102,279293.443037298,"big","D"
5218,112,69,43,79853.1697704716,"big","D"
5219,12,6,6,29871.3783838038,"mid","D"
5220,54,9,45,65103.122633043,"mid","D"
5221,91,20,71,99754.7672251484,"mid","D"
5222,77,75,2,32983.5706973507,"mid","D"
5223,251,117,134,376737.086881184,"big","D"
5224,15,4,11,30313.6022976374,"mid","D"
5225,52,32,20,40370.0590875117,"mid","D"
5226,15,8,7,23681.5504273477,"mid","D"
5227,116,116,0,57411.9493355362,"big","D"
5228,45,34,11,50053.184589127,"mid","D"
5229,153,108,45,45511.1357433328,"big","D"
5230,162,155,7,26715.6331773147,"big","D"
5231,1,0,1,728.243657818617,"small","D"
5232,16,4,12,12731.1396510455,"mid","D"
5233,99,19,80,7112.45422897299,"mid","D"
5234,20,13,7,1069.35560190259,"mid","D"
5235,109,102,7,189361.484698413,"big","D"
5236,27,19,8,18096.5708384145,"mid","D"
5237,167,8,159,244981.547589799,"big","D"
5238,73,52,21,60641.8656303202,"mid","D"
5239,72,18,54,72469.5662540939,"mid","D"
5240,6,5,1,7514.24064272755,"small","D"
5241,48,34,14,25724.1399134379,"mid","D"
5242,107,81,26,73836.4691442575,"big","D"
5243,90,74,16,97918.991567266,"mid","D"
5244,59,2,57,52494.9049574958,"mid","D"
5245,137,128,9,302349.523842427,"big","D"
5246,73,69,4,95406.4025833436,"mid","D"
5247,147,128,19,252263.784296539,"big","D"
5248,215,69,146,328184.807617395,"big","D"
5249,75,40,35,124250.360295404,"mid","D"
5250,62,19,43,55742.340660473,"mid","D"
5251,123,37,86,58949.4695215446,"big","D"
5252,87,7,80,150345.724740493,"mid","D"
5253,64,54,10,110294.281240473,"mid","D"
5254,96,10,86,209301.439541793,"mid","D"
5255,234,163,71,280531.891914559,"big","D"
5256,228,71,157,493893.292767669,"big","D"
5257,55,39,16,50233.5456522973,"mid","D"
5258,14,4,10,32594.9880838242,"mid","D"
5259,237,196,41,231864.761286655,"big","D"
5260,3,2,1,1087.34089764095,"small","D"
5261,39,4,35,3642.04728653656,"mid","D"
5262,88,13,75,26120.5531085625,"mid","D"
5263,11,5,6,25172.2561809696,"mid","D"
5264,10,7,3,16143.5413204274,"small","D"
5265,82,73,9,66124.6854692197,"mid","D"
5266,10,8,2,17199.1631927937,"small","D"
5267,94,6,88,112411.710561348,"mid","D"
5268,18,11,7,9171.64557372157,"mid","D"
5269,74,43,31,71043.0461793972,"mid","D"
5270,11,5,6,11886.615650024,"mid","D"
5271,103,100,3,22439.9659199495,"big","D"
5272,18,5,13,22156.9883505323,"mid","D"
5273,50,46,4,85261.6316178331,"mid","D"
5274,46,36,10,111001.63156998,"mid","D"
5275,35,33,2,29835.2406740881,"mid","D"
5276,33,22,11,21923.2542406072,"mid","D"
5277,4,2,2,2168.94866262239,"small","D"
5278,114,78,36,91999.9713841561,"big","D"
5279,106,28,78,83777.8972652418,"big","D"
5280,212,156,56,178519.832865361,"big","D"
5281,158,19,139,33650.5484576396,"big","D"
5282,154,35,119,125985.960586768,"big","D"
5283,41,19,22,10203.4661038308,"mid","D"
5284,185,177,8,359225.659977831,"big","D"
5285,18,9,9,840.864168961837,"mid","D"
5286,127,42,85,101242.250282799,"big","D"
5287,8,8,0,6728.1851634565,"small","D"
5288,16,13,3,30396.7640002817,"mid","D"
5289,140,45,95,7092.5506393146,"big","D"
5290,74,48,26,40388.5386947807,"mid","D"
5291,62,30,32,5024.57804846381,"mid","D"
5292,56,51,5,51861.9807434849,"mid","D"
5293,120,17,103,92399.0394482863,"big","D"
5294,45,26,19,92490.3746509077,"mid","D"
5295,141,9,132,33686.6544029318,"big","D"
5296,84,83,1,45894.2911539573,"mid","D"
5297,18,12,6,24125.8843205343,"mid","D"
5298,85,64,21,23946.1745449667,"mid","D"
5299,27,18,9,68474.6178900602,"mid","D"
5300,91,23,68,185045.88648249,"mid","D"
5301,109,59,50,177017.558291171,"big","D"
5302,39,37,2,39008.8231338979,"mid","D"
5303,57,56,1,35394.998843708,"mid","D"
5304,4,0,4,8164.37715338108,"small","D"
5305,153,0,153,40533.7842151077,"big","D"
5306,135,88,47,202099.253412788,"big","D"
5307,111,61,50,304371.630856992,"big","D"
5308,19,12,7,32461.8838078587,"mid","D"
5309,5,2,3,10486.6291884821,"small","D"
5310,39,23,16,41594.2150915178,"mid","D"
5311,187,147,40,103288.561171132,"big","D"
5312,77,74,3,151014.747993164,"mid","D"
5313,103,2,101,236026.834657827,"big","D"
5314,61,23,38,1996.07937571437,"mid","D"
5315,192,58,134,264709.198033476,"big","D"
5316,87,55,32,259963.164237859,"mid","D"
5317,118,66,52,267943.564486421,"big","D"
5318,92,20,72,85188.8502546038,"mid","D"
5319,192,18,174,615471.047920315,"big","D"
5320,72,4,68,171212.1820524,"mid","D"
5321,31,14,17,2424.62894928936,"mid","D"
5322,113,83,30,233837.531360929,"big","D"
5323,48,6,42,21902.7827284453,"mid","D"
5324,26,2,24,17527.6515836167,"mid","D"
5325,171,79,92,332569.446389706,"big","D"
5326,80,79,1,190526.87522356,"mid","D"
5327,93,10,83,1137.71376514769,"mid","D"
5328,73,17,56,95784.026101837,"mid","D"
5329,144,85,59,115351.877222176,"big","D"
5330,37,2,35,94984.4087469075,"mid","D"
5331,36,21,15,47622.0563693511,"mid","D"
5332,25,9,16,16434.4313322373,"mid","D"
5333,143,66,77,120286.650861926,"big","D"
5334,278,110,168,322465.599376602,"big","D"
5335,74,56,18,121552.406606021,"mid","D"
5336,50,40,10,33878.9566601912,"mid","D"
5337,241,85,156,360459.398935194,"big","D"
5338,5,4,1,9530.04815661886,"small","D"
5339,19,9,10,10466.7322213669,"mid","D"
5340,266,75,191,77162.5742946599,"big","D"
5341,69,16,53,85017.8771319507,"mid","D"
5342,202,187,15,681010.046475592,"big","D"
5343,28,15,13,38874.2918093906,"mid","D"
5344,21,6,15,6789.09574225869,"mid","D"
5345,12,7,5,1053.58395251215,"mid","D"
5346,114,90,24,9344.38577627612,"big","D"
5347,219,161,58,201443.185502613,"big","D"
5348,145,56,89,116360.230269419,"big","D"
5349,197,34,163,27780.5009025879,"big","D"
5350,72,9,63,71908.1779512412,"mid","D"
5351,77,38,39,237098.489411963,"mid","D"
5352,169,94,75,155347.831232926,"big","D"
5353,143,48,95,249580.792625109,"big","D"
5354,14,2,12,24273.8552554228,"mid","D"
5355,69,30,39,75019.497527688,"mid","D"
5356,50,44,6,11619.3718676084,"mid","D"
5357,75,39,36,56635.252136476,"mid","D"
5358,38,3,35,1635.87991325847,"mid","D"
5359,193,164,29,94119.9473660594,"big","D"
5360,15,15,0,1414.29297774473,"mid","D"
5361,249,235,14,582158.320778648,"big","D"
5362,65,20,45,35132.2360570374,"mid","D"
5363,42,41,1,6514.58322406662,"mid","D"
5364,160,114,46,67813.8903118391,"big","D"
5365,162,103,59,42414.7208152701,"big","D"
5366,203,24,179,305351.857670232,"big","D"
5367,42,17,25,26545.7135988973,"mid","D"
5368,5,1,4,6359.52353855298,"small","D"
5369,45,0,45,12101.8591416975,"mid","D"
5370,4,4,0,7978.04617736048,"small","D"
5371,110,69,41,146611.866488088,"big","D"
5372,21,6,15,25010.6560345154,"mid","D"
5373,100,76,24,315714.084139025,"mid","D"
5374,26,15,11,59041.9650157013,"mid","D"
5375,97,5,92,103947.528421455,"mid","D"
5376,7,4,3,9961.8938136051,"small","D"
5377,57,33,24,71858.7876029282,"mid","D"
5378,128,106,22,135262.345874779,"big","D"
5379,64,59,5,63589.5045143351,"mid","D"
5380,15,12,3,11177.8012273021,"mid","D"
5381,60,44,16,22540.8788641951,"mid","D"
5382,67,23,44,13955.6974881681,"mid","D"
5383,62,22,40,151776.2603874,"mid","D"
5384,92,58,34,13175.4240482008,"mid","D"
5385,229,40,189,224220.325923028,"big","D"
5386,39,14,25,1890.48587175683,"mid","D"
5387,211,174,37,364410.744728356,"big","D"
5388,138,128,10,96799.2102093198,"big","D"
5389,42,18,24,128370.772250923,"mid","D"
5390,42,4,38,33792.138797336,"mid","D"
5391,93,26,67,14435.822845656,"mid","D"
5392,63,49,14,104398.394068755,"mid","D"
5393,17,0,17,10324.712094698,"mid","D"
5394,26,14,12,60758.4064291195,"mid","D"
5395,162,30,132,12041.9653757317,"big","D"
5396,127,48,79,55188.7313924749,"big","D"
5397,177,100,77,209765.33674733,"big","D"
5398,70,56,14,207378.61906937,"mid","D"
5399,12,7,5,12357.382181317,"mid","D"
5400,67,18,49,133800.045480303,"mid","D"
5401,115,113,2,240387.445204065,"big","D"
5402,9,6,3,21025.3645449152,"small","D"
5403,24,18,6,12710.372571454,"mid","D"
5404,21,19,2,40672.3918251512,"mid","D"
5405,356,238,118,259929.95320089,"big","D"
5406,209,91,118,224804.381202058,"big","D"
5407,82,1,81,166893.196314647,"mid","D"
5408,23,4,19,7643.40995340706,"mid","D"
5409,121,17,104,8686.8700819458,"big","D"
5410,95,6,89,109333.712431075,"mid","D"
5411,36,34,2,39611.3166556561,"mid","D"
5412,18,12,6,11362.6062637974,"mid","D"
5413,192,37,155,173409.269447437,"big","D"
5414,58,42,16,59383.2053301419,"mid","D"
5415,24,20,4,10664.7275959417,"mid","D"
5416,67,65,2,211443.90715639,"mid","D"
5417,117,45,72,135696.552062881,"big","D"
5418,112,81,31,79069.0335910704,"big","D"
5419,85,48,37,102276.336048561,"mid","D"
5420,91,11,80,5300.95454786542,"mid","D"
5421,174,44,130,26042.5007686664,"big","D"
5422,107,28,79,230945.171196799,"big","D"
5423,68,21,47,66707.785054842,"mid","D"
5424,96,32,64,17173.314836321,"mid","D"
5425,141,12,129,148209.577241851,"big","D"
5426,21,7,14,23811.1169917069,"mid","D"
5427,52,24,28,123632.439601721,"mid","D"
5428,18,11,7,15510.9919767802,"mid","D"
5429,63,38,25,16753.0618754542,"mid","D"
5430,48,35,13,83455.2586489543,"mid","D"
5431,19,4,15,17915.9995627375,"mid","D"
5432,95,91,4,177200.177944707,"mid","D"
5433,32,3,29,6956.5061123573,"mid","D"
5434,149,96,53,398743.296296288,"big","D"
5435,86,64,22,74797.0592879012,"mid","D"
5436,48,35,13,62375.4409218753,"mid","D"
5437,107,28,79,210988.519872054,"big","D"
5438,42,8,34,39653.3617579932,"mid","D"
5439,148,130,18,10813.018882696,"big","D"
5440,47,2,45,105765.236949355,"mid","D"
5441,11,6,5,11163.3013889739,"mid","D"
5442,12,8,4,3184.95319742496,"mid","D"
5443,5,1,4,12583.0706765733,"small","D"
5444,3,0,3,1204.63704458486,"small","D"
5445,3,3,0,618.401417818811,"small","D"
5446,37,6,31,16599.8224160594,"mid","D"
5447,36,32,4,68283.9335634719,"mid","D"
5448,41,5,36,73843.8473517417,"mid","D"
5449,125,84,41,899.445839228648,"big","D"
5450,105,77,28,134471.888050679,"big","D"
5451,63,7,56,132796.307578066,"mid","D"
5452,78,58,20,80239.1788857694,"mid","D"
5453,6,4,2,13133.8109201436,"small","D"
5454,93,78,15,60987.8109893799,"mid","D"
5455,74,66,8,90292.3180578024,"mid","D"
5456,25,10,15,30525.4349995241,"mid","D"
5457,35,4,31,57849.1380895344,"mid","D"
5458,22,17,5,181.300751656967,"mid","D"
5459,7,1,6,1528.3087073349,"small","D"
5460,128,34,94,61136.2523242462,"big","D"
5461,264,234,30,205220.38141257,"big","D"
5462,45,7,38,48113.2383787684,"mid","D"
5463,166,115,51,101394.120097231,"big","D"
5464,19,16,3,49744.2834520915,"mid","D"
5465,20,1,19,3731.23333419502,"mid","D"
5466,106,87,19,138596.630130287,"big","D"
5467,96,81,15,153207.173023337,"mid","D"
5468,20,4,16,25199.4629369621,"mid","D"
5469,196,119,77,63285.0130666471,"big","D"
5470,86,70,16,78653.2376028623,"mid","D"
5471,9,7,2,12419.6607660717,"small","D"
5472,21,3,18,52460.923400976,"mid","D"
5473,95,70,25,193496.334405837,"mid","D"
5474,93,86,7,143785.6069056,"mid","D"
5475,73,26,47,63441.7522281802,"mid","D"
5476,249,84,165,163475.905139402,"big","D"
5477,35,18,17,34467.5730818813,"mid","D"
5478,53,25,28,61782.4216543329,"mid","D"
5479,74,36,38,112684.772117867,"mid","D"
5480,82,7,75,103735.311571405,"mid","D"
5481,18,6,12,4298.96142003757,"mid","D"
5482,122,7,115,150860.096856189,"big","D"
5483,81,18,63,72671.3943989652,"mid","D"
5484,109,78,31,217404.710667156,"big","D"
5485,23,14,9,19148.3615555599,"mid","D"
5486,182,24,158,31619.7267386537,"big","D"
5487,66,1,65,68813.9280891873,"mid","D"
5488,13,6,7,24139.0841056296,"mid","D"
5489,29,9,20,19335.8856517162,"mid","D"
5490,15,5,10,50250.597796066,"mid","D"
5491,113,109,4,28877.8548201004,"big","D"
5492,121,97,24,264894.322043174,"big","D"
5493,16,2,14,17281.4731161257,"mid","D"
5494,12,8,4,42998.7234987578,"mid","D"
5495,46,3,43,63292.8360629358,"mid","D"
5496,101,78,23,43363.8832224104,"big","D"
5497,5,5,0,10024.5806845752,"small","D"
5498,191,34,157,245230.721816938,"big","D"
5499,204,114,90,165692.473376041,"big","D"
5500,87,25,62,182464.546742097,"mid","D"
5501,58,27,31,161000.701296521,"mid","D"
5502,60,31,29,11463.7337029855,"mid","D"
5503,49,10,39,55343.4691090929,"mid","D"
5504,5,4,1,13016.7318991064,"small","D"
5505,89,21,68,96830.0070183104,"mid","D"
5506,31,12,19,9146.69863160833,"mid","D"
5507,138,119,19,58777.1907666404,"big","D"
5508,139,13,126,29094.0685686017,"big","D"
5509,2,1,1,3657.8591460346,"small","D"
5510,13,1,12,12912.9261036966,"mid","D"
5511,30,1,29,80774.431861171,"mid","D"
5512,11,3,8,4753.09905054663,"mid","D"
5513,54,41,13,119141.070969723,"mid","D"
5514,119,83,36,122973.636138821,"big","D"
5515,20,19,1,24313.152558639,"mid","D"
5516,186,52,134,28868.3405569824,"big","D"
5517,19,12,7,19771.232622902,"mid","D"
5518,46,31,15,32630.8270906003,"mid","D"
5519,94,65,29,18032.8758410415,"mid","D"
5520,25,19,6,30170.1625107806,"mid","D"
5521,46,38,8,34586.1226512035,"mid","D"
5522,43,3,40,65723.7120522187,"mid","D"
5523,139,21,118,16967.3270182121,"big","D"
5524,134,36,98,358364.751147577,"big","D"
5525,74,40,34,35130.0762189113,"mid","D"
5526,80,76,4,153888.270568843,"mid","D"
5527,21,16,5,36945.431389378,"mid","D"
5528,94,25,69,117773.833031728,"mid","D"
5529,130,56,74,12376.9464986844,"big","D"
5530,160,116,44,272221.822522969,"big","D"
5531,44,41,3,122943.465420749,"mid","D"
5532,43,7,36,110520.742014413,"mid","D"
5533,104,21,83,128535.884415136,"big","D"
5534,24,16,8,48236.053207109,"mid","D"
5535,9,6,3,3166.69914539209,"small","D"
5536,94,61,33,181067.294686793,"mid","D"
5537,26,8,18,18182.1700550089,"mid","D"
5538,45,40,5,114110.079136178,"mid","D"
5539,91,32,59,38147.1664223326,"mid","D"
5540,76,33,43,144341.283118956,"mid","D"
5541,73,39,34,52281.4087714844,"mid","D"
5542,122,51,71,97275.2014229249,"big","D"
5543,78,72,6,6838.61828239041,"mid","D"
5544,67,59,8,8951.02845548811,"mid","D"
5545,116,60,56,72874.5115348246,"big","D"
5546,46,46,0,76196.6887021036,"mid","D"
5547,103,102,1,65552.1253776875,"big","D"
5548,82,26,56,83870.8166285706,"mid","D"
5549,170,46,124,169974.962864118,"big","D"
5550,157,56,101,33494.1138705382,"big","D"
5551,46,26,20,50336.7588773052,"mid","D"
5552,147,27,120,341042.76572329,"big","D"
5553,81,64,17,148631.2722727,"mid","D"
5554,37,7,30,90746.0813415882,"mid","D"
5555,52,32,20,47330.7031288988,"mid","D"
5556,164,83,81,274514.176819452,"big","D"
5557,56,6,50,35267.5214559767,"mid","D"
5558,96,80,16,226888.188611743,"mid","D"
5559,5,2,3,5983.48499190586,"small","D"
5560,131,7,124,46196.6005152901,"big","D"
5561,53,27,26,64381.5729820943,"mid","D"
5562,107,99,8,50812.9229718987,"big","D"
5563,35,8,27,40982.0813668677,"mid","D"
5564,10,5,5,8494.43430281991,"small","D"
5565,115,26,89,224638.876568986,"big","D"
5566,205,115,90,119010.85193188,"big","D"
5567,5,3,2,5378.43275005915,"small","D"
5568,94,62,32,214266.030175632,"mid","D"
5569,116,67,49,228165.295006016,"big","D"
5570,139,76,63,212930.238506552,"big","D"
5571,88,84,4,121212.020287114,"mid","D"
5572,73,2,71,18642.6198121096,"mid","D"
5573,8,6,2,11552.0817588927,"small","D"
5574,252,64,188,364404.719372832,"big","D"
5575,153,5,148,140179.15493095,"big","D"
5576,12,10,2,5728.24491416583,"mid","D"
5577,42,38,4,2618.12034304204,"mid","D"
5578,79,25,54,161902.200337993,"mid","D"
5579,23,22,1,63845.5024889465,"mid","D"
5580,127,97,30,271234.020363936,"big","D"
5581,86,45,41,86961.8731127962,"mid","D"
5582,138,109,29,133728.153551848,"big","D"
5583,288,252,36,740602.241132927,"big","D"
5584,195,92,103,237159.66046392,"big","D"
5585,88,79,9,50660.2397493373,"mid","D"
5586,115,26,89,145155.56827295,"big","D"
5587,117,50,67,84864.567130899,"big","D"
5588,221,78,143,555038.39618448,"big","D"
5589,2,1,1,1326.59398440844,"small","D"
5590,37,34,3,20031.6500196011,"mid","D"
5591,70,55,15,5632.69116379961,"mid","D"
5592,249,131,118,183090.638203384,"big","D"
5593,103,5,98,234095.337028185,"big","D"
5594,97,73,24,261908.724670281,"mid","D"
5595,65,46,19,87675.8700451998,"mid","D"
5596,35,26,9,4045.15884501086,"mid","D"
5597,34,0,34,47292.3861796505,"mid","D"
5598,51,16,35,64008.8306485824,"mid","D"
5599,17,7,10,44275.8654462938,"mid","D"
5600,33,21,12,19955.9256015498,"mid","D"
5601,17,12,5,8450.74464200572,"mid","D"
5602,12,10,2,18980.271368394,"mid","D"
5603,62,8,54,7318.16388287155,"mid","D"
5604,18,16,2,11526.7819479392,"mid","D"
5605,161,96,65,285735.845367647,"big","D"
5606,66,60,6,32082.8502766889,"mid","D"
5607,119,34,85,26438.4647099095,"big","D"
5608,44,33,11,88915.6378698004,"mid","D"
5609,10,6,4,9362.69977476877,"small","D"
5610,167,96,71,223668.072770994,"big","D"
5611,127,94,33,27002.1627856622,"big","D"
5612,13,10,3,19798.7749005672,"mid","D"
5613,5,5,0,4171.46259292485,"small","D"
5614,30,15,15,30234.3374861193,"mid","D"
5615,113,80,33,91339.2692045335,"big","D"
5616,122,20,102,253008.047735473,"big","D"
5617,76,64,12,20869.1290953782,"mid","D"
5618,8,2,6,3802.38766442358,"small","D"
5619,150,0,150,219958.959424876,"big","D"
5620,137,135,2,149043.462319559,"big","D"
5621,139,39,100,268048.656000522,"big","D"
5622,45,23,22,76845.6407872804,"mid","D"
5623,148,24,124,109412.855012016,"big","D"
5624,36,26,10,16982.0102419758,"mid","D"
5625,60,33,27,47998.5291930084,"mid","D"
5626,20,2,18,4332.80192090959,"mid","D"
5627,120,63,57,161669.641794587,"big","D"
5628,121,105,16,80858.048920825,"big","D"
5629,100,20,80,3888.32924893638,"mid","D"
5630,41,21,20,65842.1806577297,"mid","D"
5631,78,8,70,30224.5579913436,"mid","D"
5632,96,9,87,182159.86369702,"mid","D"
5633,13,7,6,1127.34072761134,"mid","D"
5634,110,108,2,230512.89146422,"big","D"
5635,34,9,25,48094.5097742229,"mid","D"
5636,57,25,32,111331.637093048,"mid","D"
5637,112,55,57,227356.78700731,"big","D"
5638,127,11,116,233287.811831531,"big","D"
5639,244,7,237,362481.699155209,"big","D"
5640,39,12,27,31981.5101429233,"mid","D"
5641,80,36,44,62224.4462327586,"mid","D"
5642,25,11,14,12948.3683686606,"mid","D"
5643,106,15,91,22034.9478388226,"big","D"
5644,104,86,18,113131.3345242,"big","D"
5645,27,15,12,105683.081404663,"mid","D"
5646,5,3,2,725.899915111266,"small","D"
5647,85,6,79,117937.087501635,"mid","D"
5648,17,15,2,28518.7202144957,"mid","D"
5649,98,75,23,148112.617106556,"mid","D"
5650,59,57,2,57284.8477873153,"mid","D"
5651,175,7,168,544335.831378234,"big","D"
5652,101,57,44,61352.335585972,"big","D"
5653,35,3,32,7575.16349051919,"mid","D"
5654,128,74,54,182138.07218431,"big","D"
5655,1,1,0,305.4279436761,"small","D"
5656,22,18,4,40411.2913899675,"mid","D"
5657,8,1,7,7474.13177359202,"small","D"
5658,121,83,38,184676.336743087,"big","D"
5659,51,9,42,26552.0220617266,"mid","D"
5660,187,30,157,162876.635256441,"big","D"
5661,66,12,54,4544.60982632874,"mid","D"
5662,54,24,30,10519.6447369462,"mid","D"
5663,61,59,2,24024.168231717,"mid","D"
5664,132,37,95,237569.050920135,"big","D"
5665,27,11,16,32153.014098436,"mid","D"
5666,64,54,10,59281.5950449868,"mid","D"
5667,64,6,58,27507.2943878969,"mid","D"
5668,145,96,49,128104.22494812,"big","D"
5669,37,20,17,75482.2198741435,"mid","D"
5670,103,83,20,16334.1105730747,"big","D"
5671,181,89,92,577764.318133797,"big","D"
5672,154,111,43,91226.3983658557,"big","D"
5673,120,85,35,119472.403886934,"big","D"
5674,90,32,58,249289.228041313,"mid","D"
5675,54,39,15,25377.139123728,"mid","D"
5676,59,24,35,125773.148436159,"mid","D"
5677,80,23,57,849.412061749463,"mid","D"
5678,38,33,5,11356.8809653943,"mid","D"
5679,41,33,8,51014.6142363305,"mid","D"
5680,123,122,1,199538.658419866,"big","D"
5681,150,61,89,416619.855414915,"big","D"
5682,12,11,1,9203.66022861422,"mid","D"
5683,67,64,3,9257.51241288947,"mid","D"
5684,21,9,12,23858.8367763678,"mid","D"
5685,140,75,65,373625.242823554,"big","D"
5686,7,2,5,4361.62906177988,"small","D"
5687,88,82,6,25678.1812914192,"mid","D"
5688,120,103,17,196905.638832411,"big","D"
5689,83,42,41,8169.51154833611,"mid","D"
5690,98,40,58,167667.984682753,"mid","D"
5691,4,3,1,10787.5060253984,"small","D"
5692,49,41,8,97165.630129276,"mid","D"
5693,65,23,42,44509.906601121,"mid","D"
5694,206,116,90,405801.097370727,"big","D"
5695,79,31,48,84154.0680697183,"mid","D"
5696,184,176,8,211966.343671471,"big","D"
5697,100,9,91,33613.840726507,"mid","D"
5698,54,17,37,52443.4806860298,"mid","D"
5699,9,4,5,5110.38089289216,"small","D"
5700,126,126,0,33944.2515210382,"big","D"
5701,197,111,86,28234.8485494716,"big","D"
5702,117,100,17,305572.846124531,"big","D"
5703,249,89,160,21670.5045529203,"big","D"
5704,55,14,41,61604.7734185385,"mid","D"
5705,59,4,55,146498.178671699,"mid","D"
5706,85,37,48,225056.687840628,"mid","D"
5707,76,49,27,155367.480361898,"mid","D"
5708,66,56,10,129762.746662739,"mid","D"
5709,172,15,157,71913.4584246529,"big","D"
5710,37,14,23,22047.7274215749,"mid","D"
5711,35,21,14,56247.0818124914,"mid","D"
5712,88,12,76,308900.053263263,"mid","D"
5713,4,4,0,5762.5975273307,"small","D"
5714,145,77,68,244390.521430484,"big","D"
5715,11,6,5,702.844465920772,"mid","D"
5716,102,96,6,93711.5211001838,"big","D"
5717,357,48,309,339651.885094214,"big","D"
5718,193,12,181,4555.40996839552,"big","D"
5719,134,97,37,32155.9315077699,"big","D"
5720,22,1,21,15326.756346137,"mid","D"
5721,10,3,7,1903.4414328655,"small","D"
5722,81,15,66,91726.7656909975,"mid","D"
5723,138,126,12,20116.8695897544,"big","D"
5724,57,45,12,4938.46138848585,"mid","D"
5725,108,43,65,4619.01613009544,"big","D"
5726,106,47,59,36049.4095187603,"big","D"
5727,87,25,62,147286.194412295,"mid","D"
5728,27,7,20,41572.4418025188,"mid","D"
5729,3,2,1,2989.10119326971,"small","D"
5730,2,2,0,1012.55442553249,"small","D"
5731,38,29,9,29658.4032122461,"mid","D"
5732,16,7,9,8968.45245067229,"mid","D"
5733,85,5,80,24964.2919473637,"mid","D"
5734,99,13,86,155081.135287472,"mid","D"
5735,67,50,17,45007.4284458598,"mid","D"
5736,174,134,40,256024.912754727,"big","D"
5737,82,24,58,10290.4724422901,"mid","D"
5738,1,1,0,2167.81940982857,"small","D"
5739,47,26,21,12835.8363216552,"mid","D"
5740,5,1,4,3844.68661864938,"small","D"
5741,14,13,1,15884.6018894965,"mid","D"
5742,52,3,49,56799.6104027384,"mid","D"
5743,89,15,74,136810.614901207,"mid","D"
5744,11,6,5,34178.9037601656,"mid","D"
5745,13,2,11,6034.2385669012,"mid","D"
5746,58,10,48,945.688298880724,"mid","D"
5747,141,46,95,157036.408082115,"big","D"
5748,61,46,15,41250.1945329514,"mid","D"
5749,11,3,8,6428.31365167141,"mid","D"
5750,78,65,13,80150.9621379336,"mid","D"
5751,83,53,30,12338.302093554,"mid","D"
5752,20,12,8,8442.74941835142,"mid","D"
5753,61,38,23,105798.140692599,"mid","D"
5754,210,29,181,430485.956885766,"big","D"
5755,107,52,55,174422.792623428,"big","D"
5756,45,11,34,47923.1787280822,"mid","D"
5757,156,117,39,104551.187172132,"big","D"
5758,103,49,54,113592.948758032,"big","D"
5759,28,15,13,5857.94380180598,"mid","D"
5760,183,177,6,133966.743728607,"big","D"
5761,35,5,30,71726.8747131618,"mid","D"
5762,90,56,34,107011.79515105,"mid","D"
5763,126,88,38,62541.5912765213,"big","D"
5764,239,73,166,499316.117315381,"big","D"
5765,32,3,29,71986.4156216333,"mid","D"
5766,90,33,57,66631.4652913806,"mid","D"
5767,6,5,1,2028.1910266975,"small","D"
5768,119,106,13,181701.936666097,"big","D"
5769,106,59,47,154777.396088722,"big","D"
5770,158,49,109,176260.733316271,"big","D"
5771,77,36,41,318230.53396595,"mid","D"
5772,121,15,106,249359.0876069,"big","D"
5773,123,117,6,53589.7353947715,"big","D"
5774,124,65,59,64745.8966723684,"big","D"
5775,25,12,13,3322.0569154308,"mid","D"
5776,108,4,104,200533.909295444,"big","D"
5777,130,79,51,101649.683273861,"big","D"
5778,22,10,12,33943.0454267467,"mid","D"
5779,28,16,12,11156.9813697068,"mid","D"
5780,2,1,1,4572.46369227386,"small","D"
5781,40,39,1,32579.2596404755,"mid","D"
5782,105,102,3,248791.198287321,"big","D"
5783,65,3,62,25957.80263939,"mid","D"
5784,15,14,1,10311.9601589605,"mid","D"
5785,122,113,9,21249.6761710583,"big","D"
5786,74,7,67,53706.0888925792,"mid","D"
5787,102,84,18,167206.098028346,"big","D"
5788,91,65,26,149904.418148192,"mid","D"
5789,47,15,32,14922.4716122337,"mid","D"
5790,126,35,91,67657.5472374153,"big","D"
5791,141,43,98,209371.391969462,"big","D"
5792,131,70,61,241257.742353801,"big","D"
5793,31,21,10,56510.7767169325,"mid","D"
5794,8,7,1,7941.41351754121,"small","D"
5795,24,21,3,7334.06468689618,"mid","D"
5796,183,143,40,388660.390200301,"big","D"
5797,104,20,84,15896.2005070495,"big","D"
5798,49,43,6,32680.5481247947,"mid","D"
5799,96,16,80,118990.12518785,"mid","D"
5800,86,25,61,49636.724651947,"mid","D"
5801,148,94,54,6049.99134722109,"big","D"
5802,63,39,24,93472.4332425311,"mid","D"
5803,83,16,67,86896.3351444826,"mid","D"
5804,128,28,100,80652.3133402697,"big","D"
5805,13,9,4,30320.6181228113,"mid","D"
5806,185,12,173,443028.145017119,"big","D"
5807,12,2,10,7428.08349619691,"mid","D"
5808,63,59,4,19823.8777914797,"mid","D"
5809,92,46,46,97698.7575295315,"mid","D"
5810,43,8,35,117492.353297787,"mid","D"
5811,52,49,3,7285.47591550939,"mid","D"
5812,79,9,70,64391.6907337519,"mid","D"
5813,143,117,26,148691.525957514,"big","D"
5814,232,129,103,544208.510594345,"big","D"
5815,198,123,75,311877.940365505,"big","D"
5816,40,15,25,93666.6657291787,"mid","D"
5817,146,35,111,200330.286118091,"big","D"
5818,48,0,48,37050.1202047512,"mid","D"
5819,45,26,19,102825.713472988,"mid","D"
5820,19,4,15,8081.17448137415,"mid","D"
5821,64,27,37,62870.6237338192,"mid","D"
5822,83,73,10,134953.43431669,"mid","D"
5823,99,26,73,315973.776871976,"mid","D"
5824,34,19,15,8730.67122308682,"mid","D"
5825,81,50,31,212519.854328065,"mid","D"
5826,23,8,15,37942.8097999897,"mid","D"
5827,7,2,5,17107.2852979459,"small","D"
5828,2,0,2,2668.74152384111,"small","D"
5829,9,1,8,6501.40028422479,"small","D"
5830,181,15,166,195655.655267198,"big","D"
5831,86,78,8,11475.3502608149,"mid","D"
5832,74,28,46,63121.2578090976,"mid","D"
5833,9,6,3,2182.99414583002,"small","D"
5834,79,39,40,36807.1608822448,"mid","D"
5835,147,42,105,255947.134199344,"big","D"
5836,44,9,35,27188.9384346631,"mid","D"
5837,72,50,22,24619.3443981514,"mid","D"
5838,139,59,80,58228.8974341396,"big","D"
5839,11,8,3,10009.0468968913,"mid","D"
5840,110,99,11,178415.240323774,"big","D"
5841,44,1,43,85127.1786639873,"mid","D"
5842,114,77,37,227777.946134522,"big","D"
5843,31,2,29,34664.7320396766,"mid","D"
5844,80,70,10,110427.347842946,"mid","D"
5845,7,1,6,16885.3931283272,"small","D"
5846,49,28,21,65206.6355723523,"mid","D"
5847,3,1,2,3228.9625356129,"small","D"
5848,117,15,102,66206.5451061276,"big","D"
5849,67,20,47,20660.6211905319,"mid","D"
5850,58,23,35,90927.3254434008,"mid","D"
5851,73,37,36,91766.9338089563,"mid","D"
5852,132,64,68,168342.757749525,"big","D"
5853,39,25,14,29848.4670554676,"mid","D"
5854,108,99,9,260820.806229721,"big","D"
5855,21,0,21,20177.5822399488,"mid","D"
5856,19,13,6,12076.2843110586,"mid","D"
5857,21,14,7,2053.45532523284,"mid","D"
5858,82,49,33,104107.317858227,"mid","D"
5859,5,1,4,7457.33723828144,"small","D"
5860,25,5,20,48638.1205488147,"mid","D"
5861,45,2,43,33179.5628215326,"mid","D"
5862,105,77,28,131388.241243838,"big","D"
5863,55,17,38,27412.0477324362,"mid","D"
5864,81,30,51,85410.2385846015,"mid","D"
5865,123,33,90,27568.51874257,"big","D"
5866,79,49,30,264957.661367217,"mid","D"
5867,5,4,1,3578.0780347676,"small","D"
5868,93,48,45,155619.015430922,"mid","D"
5869,136,36,100,227325.943928925,"big","D"
5870,12,2,10,3825.61180541862,"mid","D"
5871,39,14,25,42190.1130394161,"mid","D"
5872,208,23,185,148408.328228559,"big","D"
5873,54,41,13,87943.626532741,"mid","D"
5874,90,86,4,80277.5317388625,"mid","D"
5875,2,2,0,1596.60042027362,"small","D"
5876,53,13,40,66704.7853736986,"mid","D"
5877,127,39,88,207197.987404852,"big","D"
5878,49,31,18,30007.4374346418,"mid","D"
5879,77,55,22,64351.5428435814,"mid","D"
5880,5,3,2,10952.5307386049,"small","D"
5881,279,170,109,136650.693897666,"big","D"
5882,106,54,52,93682.5198839276,"big","D"
5883,66,9,57,153131.444195224,"mid","D"
5884,27,23,4,41138.9469111418,"mid","D"
5885,71,54,17,11532.088657547,"mid","D"
5886,36,11,25,44326.9766931431,"mid","D"
5887,12,11,1,5661.94149172669,"mid","D"
5888,49,25,24,42329.2255096453,"mid","D"
5889,53,34,19,108888.508594235,"mid","D"
5890,88,34,54,76580.3640491895,"mid","D"
5891,252,103,149,179967.109613768,"big","D"
5892,16,3,13,20454.8266963831,"mid","D"
5893,112,84,28,125840.196506463,"big","D"
5894,7,4,3,4781.87491364224,"small","D"
5895,46,37,9,55089.2244241871,"mid","D"
5896,166,77,89,232209.425106772,"big","D"
5897,69,44,25,73162.1136845493,"mid","D"
5898,19,2,17,762.619160588393,"mid","D"
5899,28,27,1,54190.50361112,"mid","D"
5900,53,29,24,76044.2724678747,"mid","D"
5901,16,11,5,9968.87757823282,"mid","D"
5902,69,60,9,1782.22545974138,"mid","D"
5903,63,53,10,47300.9845376559,"mid","D"
5904,65,28,37,79926.6287021918,"mid","D"
5905,94,23,71,83799.005627258,"mid","D"
5906,51,25,26,84726.1423031943,"mid","D"
5907,75,17,58,100911.280064806,"mid","D"
5908,54,16,38,18687.1553840631,"mid","D"
5909,24,1,23,39563.9966187391,"mid","D"
5910,336,144,192,775558.099453307,"big","D"
5911,121,92,29,237613.643830328,"big","D"
5912,130,34,96,44762.3821411882,"big","D"
5913,52,20,32,64196.5010228165,"mid","D"
5914,63,42,21,33260.4948000518,"mid","D"
5915,180,137,43,172139.004120803,"big","D"
5916,44,42,2,75418.4000143916,"mid","D"
5917,41,15,26,11688.4940514474,"mid","D"
5918,199,114,85,608386.899490898,"big","D"
5919,40,8,32,13622.796584898,"mid","D"
5920,2,2,0,1199.94739849725,"small","D"
5921,194,47,147,471476.143819204,"big","D"
5922,63,26,37,115469.370943638,"mid","D"
5923,14,8,6,13639.804206674,"mid","D"
5924,192,70,122,458425.467021598,"big","D"
5925,28,8,20,21689.7619937668,"mid","D"
5926,100,88,12,14148.3001457536,"mid","D"
5927,34,7,27,114340.261064249,"mid","D"
5928,162,101,61,267243.110350359,"big","D"
5929,53,45,8,43449.6633691204,"mid","D"
5930,70,19,51,13876.7466883856,"mid","D"
5931,67,60,7,79829.1719128961,"mid","D"
5932,25,20,5,48264.2814870771,"mid","D"
5933,146,101,45,141516.58151311,"big","D"
5934,79,3,76,226463.63969638,"mid","D"
5935,221,193,28,474208.107627515,"big","D"
5936,56,6,50,60219.2129642212,"mid","D"
5937,128,36,92,192352.410262106,"big","D"
5938,9,3,6,19734.7702084919,"small","D"
5939,20,13,7,4717.10200942571,"mid","D"
5940,222,111,111,15480.5198274221,"big","D"
5941,45,34,11,93992.5150016532,"mid","D"
5942,89,3,86,18517.7451750943,"mid","D"
5943,26,18,8,66853.1717298981,"mid","D"
5944,47,18,29,21501.9754886277,"mid","D"
5945,34,7,27,59784.5374140832,"mid","D"
5946,15,13,2,19667.3559776431,"mid","D"
5947,185,67,118,139699.533656748,"big","D"
5948,23,8,15,20037.931926453,"mid","D"
5949,72,51,21,30451.7417704494,"mid","D"
5950,107,64,43,28329.757533945,"big","D"
5951,62,26,36,97821.2049194895,"mid","D"
5952,42,34,8,86286.7940337881,"mid","D"
5953,69,21,48,51695.4802392333,"mid","D"
5954,6,3,3,9254.0216154294,"small","D"
5955,22,15,7,5870.51635046826,"mid","D"
5956,7,4,3,6938.06926354736,"small","D"
5957,145,142,3,199699.267074266,"big","D"
5958,68,48,20,154924.918160588,"mid","D"
5959,210,206,4,634759.675416495,"big","D"
5960,65,43,22,27244.0360066112,"mid","D"
5961,105,6,99,84503.7917956109,"big","D"
5962,11,2,9,22825.4856023817,"mid","D"
5963,104,20,84,196063.263549614,"big","D"
5964,21,3,18,12961.9456845492,"mid","D"
5965,22,22,0,58711.7719922083,"mid","D"
5966,118,29,89,329055.143309718,"big","D"
5967,99,20,79,67413.8609187653,"mid","D"
5968,17,4,13,27203.2266269147,"mid","D"
5969,27,17,10,46787.1352944316,"mid","D"
5970,49,18,31,90290.1871153788,"mid","D"
5971,36,1,35,70661.0180617352,"mid","D"
5972,34,28,6,83232.0463995589,"mid","D"
5973,44,27,17,51158.9825112662,"mid","D"
5974,257,232,25,548692.74585559,"big","D"
5975,49,39,10,25232.1128742592,"mid","D"
5976,71,9,62,129533.863419344,"mid","D"
5977,122,101,21,216895.440656412,"big","D"
5978,132,47,85,118549.108436049,"big","D"
5979,4,3,1,561.610007067555,"small","D"
5980,44,18,26,4018.24831435291,"mid","D"
5981,195,53,142,545616.675391707,"big","D"
5982,85,22,63,200006.767176737,"mid","D"
5983,14,5,9,4511.79219043954,"mid","D"
5984,63,25,38,20198.0588974492,"mid","D"
5985,92,78,14,300061.372564094,"mid","D"
5986,99,82,17,143044.468731684,"mid","D"
5987,66,60,6,52509.7550890261,"mid","D"
5988,20,11,9,5854.49959593405,"mid","D"
5989,64,36,28,166136.376559961,"mid","D"
5990,32,19,13,83360.9477607384,"mid","D"
5991,55,32,23,206622.849867374,"mid","D"
5992,46,13,33,82374.1239315413,"mid","D"
5993,97,76,21,109699.071000249,"mid","D"
5994,103,97,6,197925.710401696,"big","D"
5995,55,49,6,46139.9652712272,"mid","D"
5996,69,33,36,91354.3564443027,"mid","D"
5997,139,66,73,78895.2082915433,"big","D"
5998,93,24,69,50185.2633227455,"mid","D"
5999,112,20,92,128605.948842816,"big","D"
6000,15,9,6,2479.12301204447,"mid","D"
6001,109,43,66,202578.261648187,"big","E"
6002,109,74,35,35006.8145227108,"big","E"
6003,54,41,13,748.667070937173,"mid","E"
6004,22,5,17,2800.80290102261,"mid","E"
6005,49,43,6,37136.4917287416,"mid","E"
6006,9,5,4,14983.8800597396,"small","E"
6007,1,1,0,1286.51149191315,"small","E"
6008,62,62,0,2867.72426583714,"mid","E"
6009,154,31,123,24523.9807842961,"big","E"
6010,70,30,40,77023.0387256062,"mid","E"
6011,173,12,161,44451.142230681,"big","E"
6012,52,38,14,17516.1728123319,"mid","E"
6013,117,31,86,294898.654524076,"big","E"
6014,47,9,38,52336.1391442207,"mid","E"
6015,15,6,9,1357.20268578635,"mid","E"
6016,72,49,23,30419.9969984642,"mid","E"
6017,2,2,0,2158.67460243325,"small","E"
6018,147,18,129,227947.805697699,"big","E"
6019,127,111,16,35682.3077503,"big","E"
6020,68,12,56,91620.0491729035,"mid","E"
6021,82,2,80,166501.009325982,"mid","E"
6022,131,52,79,241030.38420586,"big","E"
6023,366,322,44,402645.961193207,"big","E"
6024,143,61,82,22562.3963394237,"big","E"
6025,205,10,195,183540.337145892,"big","E"
6026,11,3,8,3160.46038280894,"mid","E"
6027,139,16,123,154014.613532847,"big","E"
6028,88,77,11,77586.7351585898,"mid","E"
6029,77,12,65,179007.732714798,"mid","E"
6030,27,12,15,87567.9015581708,"mid","E"
6031,48,9,39,30826.6331386535,"mid","E"
6032,83,3,80,80972.2306805544,"mid","E"
6033,129,31,98,15765.2355610964,"big","E"
6034,125,112,13,150840.209362107,"big","E"
6035,2,1,1,2081.57188445313,"small","E"
6036,280,2,278,446727.582631801,"big","E"
6037,48,0,48,64026.3192961711,"mid","E"
6038,49,34,15,98041.3897925719,"mid","E"
6039,31,3,28,30175.2741491515,"mid","E"
6040,168,38,130,346119.243441718,"big","E"
6041,191,166,25,234004.369837971,"big","E"
6042,12,4,8,16837.7321000009,"mid","E"
6043,136,23,113,140970.770489021,"big","E"
6044,139,21,118,95344.4513916102,"big","E"
6045,37,31,6,46233.5932184295,"mid","E"
6046,5,3,2,6132.819847925,"small","E"
6047,78,23,55,77793.4855640349,"mid","E"
6048,110,0,110,31009.0411969861,"big","E"
6049,47,14,33,66256.45684398,"mid","E"
6050,38,14,24,79872.2022323127,"mid","E"
6051,45,21,24,67699.505026317,"mid","E"
6052,61,32,29,34714.2039143809,"mid","E"
6053,19,9,10,36524.1583154203,"mid","E"
6054,38,33,5,80231.1596866628,"mid","E"
6055,19,13,6,9689.48098132504,"mid","E"
6056,275,151,124,88683.0257784121,"big","E"
6057,45,7,38,133979.032593817,"mid","E"
6058,39,35,4,38925.5763374365,"mid","E"
6059,176,106,70,425401.943691438,"big","E"
6060,43,6,37,23523.1681433047,"mid","E"
6061,164,131,33,298863.706138823,"big","E"
6062,89,86,3,93459.908884472,"mid","E"
6063,214,74,140,21246.9229781851,"big","E"
6064,17,17,0,44806.9137361423,"mid","E"
6065,57,7,50,25949.7814334563,"mid","E"
6066,58,13,45,53607.0531343075,"mid","E"
6067,257,194,63,514456.493548598,"big","E"
6068,34,20,14,88848.9856000914,"mid","E"
6069,207,145,62,132072.012140683,"big","E"
6070,5,1,4,511.223115947744,"small","E"
6071,18,2,16,6109.72633948111,"mid","E"
6072,26,10,16,17379.174633256,"mid","E"
6073,63,21,42,57536.5124560263,"mid","E"
6074,14,3,11,23666.1289235007,"mid","E"
6075,182,80,102,269477.556095749,"big","E"
6076,123,78,45,170279.905585571,"big","E"
6077,216,161,55,133074.617302308,"big","E"
6078,200,139,61,15797.7243183461,"big","E"
6079,24,8,16,28488.2793660898,"mid","E"
6080,52,42,10,145643.46625129,"mid","E"
6081,148,115,33,12597.5189001072,"big","E"
6082,39,11,28,56163.6707475706,"mid","E"
6083,22,12,10,33875.6089544331,"mid","E"
6084,49,27,22,100226.940901537,"mid","E"
6085,100,44,56,306048.546781861,"mid","E"
6086,228,25,203,364763.45257008,"big","E"
6087,98,72,26,160557.977056682,"mid","E"
6088,73,4,69,128243.017903673,"mid","E"
6089,70,21,49,79313.0461702237,"mid","E"
6090,114,81,33,123702.919921986,"big","E"
6091,204,167,37,203396.92883974,"big","E"
6092,75,39,36,137106.794247609,"mid","E"
6093,4,1,3,6348.89113209181,"small","E"
6094,100,52,48,174228.448183281,"mid","E"
6095,30,9,21,14544.9713314224,"mid","E"
6096,7,5,2,3569.01272297206,"small","E"
6097,7,4,3,5130.17685623323,"small","E"
6098,139,78,61,159501.183449657,"big","E"
6099,41,2,39,43575.8138676708,"mid","E"
6100,33,28,5,58314.3302314838,"mid","E"
6101,154,104,50,16015.8194138204,"big","E"
6102,107,2,105,124800.750447039,"big","E"
6103,82,63,19,141288.474044028,"mid","E"
6104,32,10,22,37900.0024563629,"mid","E"
6105,125,42,83,257860.271665987,"big","E"
6106,71,32,39,92668.7315816849,"mid","E"
6107,110,23,87,21579.9760571504,"big","E"
6108,128,61,67,115832.580065492,"big","E"
6109,1,1,0,1100.34154191828,"small","E"
6110,3,1,2,3093.26801771393,"small","E"
6111,184,85,99,119575.259156648,"big","E"
6112,6,6,0,9947.89022144903,"small","E"
6113,3,2,1,6347.02376293434,"small","E"
6114,72,29,43,20071.6821653615,"mid","E"
6115,20,2,18,45852.4969244668,"mid","E"
6116,240,137,103,510004.21056249,"big","E"
6117,25,23,2,24645.6515169617,"mid","E"
6118,42,25,17,88042.5738271501,"mid","E"
6119,102,7,95,16598.9389803029,"big","E"
6120,85,61,24,7460.37799890343,"mid","E"
6121,35,29,6,6910.97173031329,"mid","E"
6122,77,29,48,30697.9303728442,"mid","E"
6123,14,4,10,33417.2968102575,"mid","E"
6124,111,34,77,185722.124742753,"big","E"
6125,106,57,49,113575.904587938,"big","E"
6126,54,24,30,52665.3473434044,"mid","E"
6127,93,75,18,26762.9318548989,"mid","E"
6128,23,1,22,16105.6110859484,"mid","E"
6129,31,15,16,51171.4500265247,"mid","E"
6130,64,17,47,50238.1062680861,"mid","E"
6131,188,31,157,347300.100791288,"big","E"
6132,177,10,167,171833.594409552,"big","E"
6133,137,104,33,137610.244561403,"big","E"
6134,6,6,0,10950.5240466915,"small","E"
6135,170,127,43,157828.926995187,"big","E"
6136,30,4,26,34963.1330405957,"mid","E"
6137,12,5,7,11456.5899189865,"mid","E"
6138,119,83,36,143113.92642774,"big","E"
6139,90,78,12,55746.8347077215,"mid","E"
6140,46,19,27,117610.425528143,"mid","E"
6141,168,38,130,488570.674061221,"big","E"
6142,16,14,2,26961.5713137426,"mid","E"
6143,75,22,53,113761.796782575,"mid","E"
6144,84,30,54,135638.566193154,"mid","E"
6145,36,1,35,70318.0052816326,"mid","E"
6146,63,30,33,4144.06941977753,"mid","E"
6147,147,39,108,59477.9749779457,"big","E"
6148,187,130,57,131329.995542289,"big","E"
6149,107,62,45,52683.6687657564,"big","E"
6150,12,4,8,8576.16387477732,"mid","E"
6151,26,12,14,23684.8558114367,"mid","E"
6152,46,13,33,54608.034447171,"mid","E"
6153,122,90,32,16631.6536346554,"big","E"
6154,119,30,89,2160.13317457857,"big","E"
6155,72,49,23,86795.3743486319,"mid","E"
6156,59,25,34,33035.5214337997,"mid","E"
6157,47,25,22,58700.2887290574,"mid","E"
6158,25,18,7,24627.8301438004,"mid","E"
6159,11,5,6,17118.2626807598,"mid","E"
6160,108,53,55,126476.015532772,"big","E"
6161,91,28,63,5086.48898659619,"mid","E"
6162,112,66,46,14751.8687549016,"big","E"
6163,10,2,8,7833.63044369391,"small","E"
6164,92,24,68,146409.677793711,"mid","E"
6165,43,11,32,103594.412271134,"mid","E"
6166,6,2,4,2112.82940393413,"small","E"
6167,24,10,14,10918.742748122,"mid","E"
6168,58,34,24,42114.6976600722,"mid","E"
6169,13,9,4,23651.6020101167,"mid","E"
6170,163,152,11,252126.555397644,"big","E"
6171,74,15,59,62451.7066050578,"mid","E"
6172,180,1,179,70109.1884397984,"big","E"
6173,67,9,58,92628.8289939,"mid","E"
6174,203,188,15,147915.286730426,"big","E"
6175,7,7,0,6095.04311923505,"small","E"
6176,14,13,1,15632.0534305881,"mid","E"
6177,72,21,51,28177.6493266149,"mid","E"
6178,27,2,25,1290.25595210196,"mid","E"
6179,1,1,0,257.465655725432,"small","E"
6180,53,14,39,51869.0187944579,"mid","E"
6181,172,24,148,108949.38067357,"big","E"
6182,117,14,103,129445.774609061,"big","E"
6183,75,26,49,88683.4941703171,"mid","E"
6184,64,36,28,128852.619599353,"mid","E"
6185,21,0,21,27167.1385674732,"mid","E"
6186,88,31,57,9907.0696540004,"mid","E"
6187,60,44,16,44580.9998847043,"mid","E"
6188,21,3,18,5969.214466028,"mid","E"
6189,45,32,13,36276.3018968091,"mid","E"
6190,12,9,3,2188.15792269071,"mid","E"
6191,48,22,26,44032.7113639471,"mid","E"
6192,53,49,4,145740.029181019,"mid","E"
6193,161,90,71,26794.666169917,"big","E"
6194,41,26,15,58771.1494003936,"mid","E"
6195,60,38,22,69934.0879287952,"mid","E"
6196,148,83,65,277194.611016073,"big","E"
6197,46,23,23,135578.185047919,"mid","E"
6198,51,10,41,68499.0005686547,"mid","E"
6199,18,4,14,7882.18254987365,"mid","E"
6200,18,0,18,17534.0297775998,"mid","E"
6201,109,101,8,257363.96618736,"big","E"
6202,47,27,20,129816.230730547,"mid","E"
6203,25,6,19,51796.5605469855,"mid","E"
6204,97,95,2,60160.4292369497,"mid","E"
6205,127,3,124,62595.5244524836,"big","E"
6206,118,26,92,77798.7774156877,"big","E"
6207,10,5,5,7310.51445704986,"small","E"
6208,20,20,0,14074.1148462915,"mid","E"
6209,1,0,1,874.430701795594,"small","E"
6210,43,17,26,62181.0192250912,"mid","E"
6211,53,0,53,7901.04612956921,"mid","E"
6212,170,120,50,154014.59828834,"big","E"
6213,62,3,59,92416.7965094132,"mid","E"
6214,235,71,164,207075.895265075,"big","E"
6215,120,44,76,9313.28572289483,"big","E"
6216,21,6,15,11031.1415725072,"mid","E"
6217,109,49,60,80587.8626838062,"big","E"
6218,15,5,10,9116.50520481665,"mid","E"
6219,11,2,9,12031.4411812415,"mid","E"
6220,78,24,54,168007.449797659,"mid","E"
6221,183,4,179,6364.49882716336,"big","E"
6222,17,1,16,3250.11035674838,"mid","E"
6223,143,142,1,11665.0325100554,"big","E"
6224,186,92,94,87180.6570316961,"big","E"
6225,4,4,0,551.361697449444,"small","E"
6226,11,10,1,666.704676549721,"mid","E"
6227,71,51,20,157581.004908582,"mid","E"
6228,71,1,70,114757.772643711,"mid","E"
6229,51,36,15,36756.116422098,"mid","E"
6230,5,2,3,8774.49630970042,"small","E"
6231,185,110,75,54017.0435941806,"big","E"
6232,67,10,57,161131.12874873,"mid","E"
6233,57,46,11,123.822673828971,"mid","E"
6234,45,18,27,32369.5041418665,"mid","E"
6235,72,25,47,100433.731444309,"mid","E"
6236,34,11,23,5166.96712541249,"mid","E"
6237,64,26,38,17887.5698234515,"mid","E"
6238,157,103,54,279658.275266505,"big","E"
6239,17,16,1,15135.0076730017,"mid","E"
6240,71,32,39,139403.176427601,"mid","E"
6241,24,3,21,33905.3037729084,"mid","E"
6242,72,4,68,131166.256669498,"mid","E"
6243,87,20,67,24118.4135269196,"mid","E"
6244,44,38,6,119330.570259034,"mid","E"
6245,85,35,50,57919.0112175766,"mid","E"
6246,113,46,67,47305.7711709756,"big","E"
6247,161,68,93,62893.6027425643,"big","E"
6248,52,19,33,17225.1431220879,"mid","E"
6249,70,15,55,59148.7230710092,"mid","E"
6250,61,29,32,66953.2394869874,"mid","E"
6251,135,34,101,287302.154387067,"big","E"
6252,13,7,6,3697.15536432455,"mid","E"
6253,129,88,41,58082.1701743002,"big","E"
6254,302,45,257,160417.969611673,"big","E"
6255,60,12,48,223489.131299754,"mid","E"
6256,128,108,20,330845.301573197,"big","E"
6257,98,23,75,95811.734615996,"mid","E"
6258,17,17,0,13146.5278450464,"mid","E"
6259,74,28,46,59601.2188624765,"mid","E"
6260,112,20,92,79331.4181947724,"big","E"
6261,92,5,87,5324.63704223588,"mid","E"
6262,79,74,5,66485.270342989,"mid","E"
6263,167,7,160,493905.125922991,"big","E"
6264,154,147,7,132346.482655398,"big","E"
6265,163,23,140,165044.730184936,"big","E"
6266,49,0,49,117270.312219022,"mid","E"
6267,87,37,50,95107.2764377488,"mid","E"
6268,121,71,50,56470.2228377983,"big","E"
6269,142,86,56,13224.4211547937,"big","E"
6270,164,54,110,86148.621930341,"big","E"
6271,40,6,34,15544.6617191976,"mid","E"
6272,50,34,16,41581.3431542398,"mid","E"
6273,82,61,21,38835.4890902717,"mid","E"
6274,72,49,23,34821.7635758229,"mid","E"
6275,78,17,61,97401.2465643034,"mid","E"
6276,1,1,0,2163.54754294088,"small","E"
6277,28,16,12,20914.938929443,"mid","E"
6278,55,24,31,14559.3241213385,"mid","E"
6279,75,15,60,35424.1773572234,"mid","E"
6280,149,127,22,2533.10998546636,"big","E"
6281,38,8,30,63602.1510010185,"mid","E"
6282,222,157,65,301426.848411774,"big","E"
6283,167,33,134,70069.8687310627,"big","E"
6284,118,117,1,201732.501671538,"big","E"
6285,69,34,35,222090.594657106,"mid","E"
6286,26,7,19,20610.7861005096,"mid","E"
6287,101,6,95,101742.330007674,"big","E"
6288,106,59,47,155387.772162912,"big","E"
6289,35,32,3,84185.0555089935,"mid","E"
6290,91,7,84,127283.801537977,"mid","E"
6291,210,147,63,77323.6555469005,"big","E"
6292,84,68,16,19439.626651018,"mid","E"
6293,1,0,1,698.338336888102,"small","E"
6294,167,27,140,276482.345308071,"big","E"
6295,72,54,18,9379.32593010044,"mid","E"
6296,129,86,43,214907.191262557,"big","E"
6297,217,56,161,369212.314913281,"big","E"
6298,132,69,63,20694.2966785254,"big","E"
6299,208,131,77,126868.372946891,"big","E"
6300,169,17,152,5118.38402756971,"big","E"
6301,111,9,102,250139.976972805,"big","E"
6302,151,116,35,138173.440398663,"big","E"
6303,147,112,35,216700.180533986,"big","E"
6304,12,9,3,14955.0291676289,"mid","E"
6305,23,11,12,6057.80715146576,"mid","E"
6306,215,156,59,232281.661238997,"big","E"
6307,11,1,10,9024.62670862209,"mid","E"
6308,68,10,58,65445.8104514605,"mid","E"
6309,10,1,9,16130.0663680215,"small","E"
6310,2,1,1,6352.8587072673,"small","E"
6311,86,31,55,139919.475741922,"mid","E"
6312,162,137,25,37127.5866950996,"big","E"
6313,139,80,59,66705.3578416772,"big","E"
6314,118,72,46,449076.752267086,"big","E"
6315,100,58,42,117936.097067742,"mid","E"
6316,381,104,277,185237.622853276,"big","E"
6317,111,84,27,40950.2348553041,"big","E"
6318,227,187,40,304752.450670505,"big","E"
6319,154,74,80,307125.326909355,"big","E"
6320,144,111,33,71288.7717255661,"big","E"
6321,6,4,2,1620.85666242096,"small","E"
6322,218,82,136,44424.9764867672,"big","E"
6323,184,68,116,90774.9393476667,"big","E"
6324,165,72,93,29340.0730078854,"big","E"
6325,159,155,4,102289.497674735,"big","E"
6326,2,0,2,3040.72603743683,"small","E"
6327,117,54,63,63097.4478449479,"big","E"
6328,43,32,11,6313.07802578263,"mid","E"
6329,92,10,82,214164.476093325,"mid","E"
6330,25,15,10,13141.0373227427,"mid","E"
6331,110,5,105,63050.2315816307,"big","E"
6332,80,59,21,3138.63982147323,"mid","E"
6333,92,14,78,122977.610248526,"mid","E"
6334,80,52,28,4098.34097102456,"mid","E"
6335,68,5,63,70143.2505866954,"mid","E"
6336,104,26,78,150124.653823088,"big","E"
6337,55,5,50,121253.909406974,"mid","E"
6338,31,6,25,7138.61319590807,"mid","E"
6339,33,24,9,109223.198750012,"mid","E"
6340,2,2,0,3875.91829882308,"small","E"
6341,163,14,149,1608.37719521886,"big","E"
6342,172,102,70,644354.718748441,"big","E"
6343,82,53,29,21259.9736101931,"mid","E"
6344,84,59,25,38076.861554759,"mid","E"
6345,129,60,69,71738.5793396688,"big","E"
6346,59,34,25,30203.2485588046,"mid","E"
6347,120,17,103,68168.1188604262,"big","E"
6348,11,10,1,3137.5856012893,"mid","E"
6349,93,87,6,85868.3946631724,"mid","E"
6350,53,20,33,22177.1240405469,"mid","E"
6351,185,178,7,487304.685531252,"big","E"
6352,121,4,117,58391.3119829036,"big","E"
6353,26,7,19,11274.4714841984,"mid","E"
6354,239,8,231,520254.168266121,"big","E"
6355,110,32,78,59478.0084460052,"big","E"
6356,55,3,52,20918.0697972084,"mid","E"
6357,40,5,35,65655.8635240415,"mid","E"
6358,6,2,4,10930.6289358708,"small","E"
6359,10,8,2,530.627615858849,"small","E"
6360,9,1,8,2934.59226786061,"small","E"
6361,70,44,26,58302.9713147963,"mid","E"
6362,37,27,10,6128.44777777447,"mid","E"
6363,90,25,65,141902.886541601,"mid","E"
6364,376,75,301,277271.978058208,"big","E"
6365,33,33,0,28187.4952944302,"mid","E"
6366,78,75,3,16511.5028234624,"mid","E"
6367,172,126,46,350990.230601129,"big","E"
6368,50,50,0,122276.797872242,"mid","E"
6369,139,99,40,325061.151651042,"big","E"
6370,54,4,50,73532.603667852,"mid","E"
6371,2,1,1,599.274672465289,"small","E"
6372,21,7,14,6802.92399641406,"mid","E"
6373,56,28,28,68867.5254118535,"mid","E"
6374,194,115,79,155010.818021099,"big","E"
6375,11,8,3,25343.6462469427,"mid","E"
6376,39,4,35,84705.6589253087,"mid","E"
6377,102,70,32,44564.9130181176,"big","E"
6378,13,12,1,18700.4399047116,"mid","E"
6379,33,7,26,33702.1063643708,"mid","E"
6380,88,66,22,91198.9058567548,"mid","E"
6381,38,35,3,19362.1451343279,"mid","E"
6382,27,1,26,39302.631538836,"mid","E"
6383,156,52,104,170660.109534009,"big","E"
6384,58,24,34,122859.143662344,"mid","E"
6385,64,48,16,101355.119169183,"mid","E"
6386,59,29,30,1767.35133245925,"mid","E"
6387,58,52,6,122229.70814279,"mid","E"
6388,9,2,7,2742.23136773916,"small","E"
6389,11,5,6,11967.1531612477,"mid","E"
6390,23,18,5,52304.7996922395,"mid","E"
6391,87,46,41,142641.128611804,"mid","E"
6392,90,45,45,16512.4097930088,"mid","E"
6393,79,41,38,245110.920362708,"mid","E"
6394,38,35,3,8713.69729317321,"mid","E"
6395,8,5,3,10110.353000911,"small","E"
6396,31,4,27,24418.3634074547,"mid","E"
6397,11,10,1,18331.3287707061,"mid","E"
6398,114,58,56,39365.3401476429,"big","E"
6399,30,12,18,12356.0391916054,"mid","E"
6400,41,21,20,49616.9764670281,"mid","E"
6401,11,6,5,18627.2931041096,"mid","E"
6402,12,7,5,1726.02357933437,"mid","E"
6403,8,4,4,5428.19367097693,"small","E"
6404,114,55,59,34238.2084013212,"big","E"
6405,12,9,3,29080.2415727032,"mid","E"
6406,16,5,11,4684.22843681662,"mid","E"
6407,38,34,4,24438.3627923775,"mid","E"
6408,34,17,17,52245.9200248633,"mid","E"
6409,108,56,52,38094.5915796284,"big","E"
6410,24,15,9,31065.1509635049,"mid","E"
6411,272,147,125,242249.175484515,"big","E"
6412,83,20,63,145981.489969392,"mid","E"
6413,155,49,106,67860.2875962157,"big","E"
6414,4,3,1,1771.11782702713,"small","E"
6415,107,71,36,189428.909283708,"big","E"
6416,162,27,135,13194.6571782699,"big","E"
6417,155,84,71,204252.324675577,"big","E"
6418,10,9,1,4429.82897955747,"small","E"
6419,138,103,35,109702.496701693,"big","E"
6420,222,137,85,302411.628822694,"big","E"
6421,116,87,29,166913.231471736,"big","E"
6422,32,17,15,10323.7370626004,"mid","E"
6423,73,27,46,253114.983226478,"mid","E"
6424,203,81,122,312495.084061361,"big","E"
6425,198,118,80,358646.755764921,"big","E"
6426,151,106,45,379018.39300744,"big","E"
6427,150,6,144,79677.5913153905,"big","E"
6428,36,26,10,48517.5930099475,"mid","E"
6429,148,117,31,13566.7926556396,"big","E"
6430,168,94,74,11874.131105976,"big","E"
6431,29,12,17,8892.14998784627,"mid","E"
6432,54,26,28,14767.3417408882,"mid","E"
6433,15,7,8,11550.9551721647,"mid","E"
6434,68,36,32,27741.1908060923,"mid","E"
6435,42,39,3,37495.0531956413,"mid","E"
6436,84,35,49,136660.569476724,"mid","E"
6437,36,1,35,97170.3304571787,"mid","E"
6438,43,39,4,27449.0584924631,"mid","E"
6439,43,6,37,40916.9150464011,"mid","E"
6440,187,102,85,6575.54081830749,"big","E"
6441,52,21,31,27652.991985875,"mid","E"
6442,160,50,110,54421.4927850311,"big","E"
6443,10,10,0,28451.2309623409,"small","E"
6444,171,75,96,70335.1854836489,"big","E"
6445,22,16,6,37897.0249082783,"mid","E"
6446,1,0,1,493.98873013463,"small","E"
6447,165,98,67,423089.716483517,"big","E"
6448,4,0,4,6932.76305159241,"small","E"
6449,18,11,7,11768.2482506476,"mid","E"
6450,74,41,33,47852.417887989,"mid","E"
6451,2,2,0,2026.8096126347,"small","E"
6452,127,84,43,213753.068516208,"big","E"
6453,190,148,42,347475.115245315,"big","E"
6454,109,106,3,20416.2854566056,"big","E"
6455,74,25,49,160588.837835242,"mid","E"
6456,80,15,65,31722.5289821854,"mid","E"
6457,24,15,9,31067.1409325866,"mid","E"
6458,33,19,14,10254.1810127366,"mid","E"
6459,119,74,45,137157.567597301,"big","E"
6460,13,10,3,3404.58515315633,"mid","E"
6461,37,36,1,73136.2762286082,"mid","E"
6462,92,60,32,177869.512148451,"mid","E"
6463,125,3,122,1946.69308264844,"big","E"
6464,80,41,39,17147.8692555877,"mid","E"
6465,33,2,31,19841.4484378847,"mid","E"
6466,132,126,6,71710.9754616436,"big","E"
6467,66,38,28,124896.282218383,"mid","E"
6468,180,88,92,360563.786693855,"big","E"
6469,177,125,52,7172.69083031346,"big","E"
6470,17,7,10,26323.975229625,"mid","E"
6471,70,46,24,141795.853407281,"mid","E"
6472,163,72,91,134833.457683218,"big","E"
6473,104,102,2,164540.445963343,"big","E"
6474,43,29,14,41614.076446687,"mid","E"
6475,130,22,108,15754.3327812079,"big","E"
6476,135,133,2,73678.183357469,"big","E"
6477,35,19,16,31188.2369087122,"mid","E"
6478,56,20,36,52937.8922016419,"mid","E"
6479,21,4,17,12628.8958142376,"mid","E"
6480,79,77,2,6377.57501940456,"mid","E"
6481,53,51,2,146241.641300082,"mid","E"
6482,24,0,24,52804.0847432927,"mid","E"
6483,12,9,3,18166.0686000746,"mid","E"
6484,243,208,35,354488.667171523,"big","E"
6485,187,82,105,160568.641586153,"big","E"
6486,125,38,87,195715.055214943,"big","E"
6487,45,32,13,34871.7460982481,"mid","E"
6488,13,1,12,5868.27569240138,"mid","E"
6489,94,71,23,130477.950290524,"mid","E"
6490,55,16,39,34389.2793341916,"mid","E"
6491,1,1,0,822.094935305362,"small","E"
6492,99,11,88,85604.0076989512,"mid","E"
6493,82,2,80,56831.7566880342,"mid","E"
6494,59,57,2,95630.1578283476,"mid","E"
6495,27,11,16,57418.0665642897,"mid","E"
6496,259,225,34,519580.258577315,"big","E"
6497,81,16,65,63877.2587801282,"mid","E"
6498,102,86,16,4569.53667105398,"big","E"
6499,8,4,4,15681.5144518131,"small","E"
6500,98,19,79,55284.1019642375,"mid","E"
6501,106,72,34,54883.2575258203,"big","E"
6502,73,55,18,19468.2853482031,"mid","E"
6503,80,6,74,4392.61368264419,"mid","E"
6504,6,2,4,16309.8491855912,"small","E"
6505,37,29,8,11130.4308833178,"mid","E"
6506,82,4,78,171931.747574914,"mid","E"
6507,87,34,53,89810.3522067852,"mid","E"
6508,80,75,5,113499.104138656,"mid","E"
6509,16,7,9,48645.9149531776,"mid","E"
6510,152,21,131,79396.1491092856,"big","E"
6511,78,32,46,12384.4835644787,"mid","E"
6512,182,39,143,177954.031334201,"big","E"
6513,27,22,5,71712.9206946747,"mid","E"
6514,4,3,1,2198.95497130887,"small","E"
6515,120,42,78,261092.227171403,"big","E"
6516,13,2,11,4216.8710852161,"mid","E"
6517,143,32,111,257162.996543058,"big","E"
6518,84,30,54,72075.2501504317,"mid","E"
6519,23,21,2,65368.4111214699,"mid","E"
6520,66,47,19,124538.310960255,"mid","E"
6521,116,67,49,212556.471121997,"big","E"
6522,17,7,10,7310.2641747987,"mid","E"
6523,136,108,28,212287.759730602,"big","E"
6524,98,12,86,305376.003894207,"mid","E"
6525,10,10,0,1833.30411553006,"small","E"
6526,111,59,52,150003.340608611,"big","E"
6527,71,69,2,83898.1773438288,"mid","E"
6528,85,30,55,78839.9597273556,"mid","E"
6529,18,5,13,38749.2255132993,"mid","E"
6530,31,11,20,45708.3228272314,"mid","E"
6531,152,16,136,384635.748417577,"big","E"
6532,111,12,99,119168.618357044,"big","E"
6533,117,60,57,418725.050903192,"big","E"
6534,63,27,36,93548.0793567743,"mid","E"
6535,33,18,15,6241.38147043197,"mid","E"
6536,53,15,38,90694.3537493544,"mid","E"
6537,53,13,40,11434.8345601881,"mid","E"
6538,38,6,32,62635.6546983941,"mid","E"
6539,5,4,1,501.903525146247,"small","E"
6540,30,24,6,58108.8328182792,"mid","E"
6541,107,38,69,81681.5651492795,"big","E"
6542,165,122,43,86791.3531706651,"big","E"
6543,30,16,14,11138.6189730918,"mid","E"
6544,63,21,42,77088.483860723,"mid","E"
6545,12,3,9,22843.5957491537,"mid","E"
6546,255,159,96,123999.253155257,"big","E"
6547,153,61,92,372592.847944786,"big","E"
6548,25,9,16,7153.93683598656,"mid","E"
6549,26,17,9,28558.2713476404,"mid","E"
6550,49,14,35,38640.2490879995,"mid","E"
6551,21,15,6,20713.6739959206,"mid","E"
6552,38,23,15,31481.1552761237,"mid","E"
6553,71,55,16,182026.704676771,"mid","E"
6554,57,34,23,113095.62492174,"mid","E"
6555,4,4,0,3529.85520467087,"small","E"
6556,20,6,14,12567.8899270574,"mid","E"
6557,47,21,26,11456.7959930947,"mid","E"
6558,181,115,66,468134.39845103,"big","E"
6559,163,43,120,496106.561498618,"big","E"
6560,70,22,48,66564.0293338015,"mid","E"
6561,55,41,14,208076.484183856,"mid","E"
6562,88,57,31,72383.1981905089,"mid","E"
6563,27,25,2,58946.2989438043,"mid","E"
6564,60,1,59,32111.8321332422,"mid","E"
6565,38,10,28,15516.5545553376,"mid","E"
6566,71,66,5,59318.0044532559,"mid","E"
6567,31,17,14,20720.4515128783,"mid","E"
6568,27,19,8,31237.7589411888,"mid","E"
6569,12,3,9,3722.0989421092,"mid","E"
6570,109,75,34,38445.1558570617,"big","E"
6571,116,78,38,25558.3255488178,"big","E"
6572,11,4,7,29487.2191408438,"mid","E"
6573,102,10,92,253974.193395299,"big","E"
6574,21,8,13,3172.72740312771,"mid","E"
6575,7,1,6,4744.78798827382,"small","E"
6576,134,110,24,49941.1700384909,"big","E"
6577,58,3,55,85559.9193759426,"mid","E"
6578,20,10,10,31511.8144452096,"mid","E"
6579,106,89,17,257685.93599393,"big","E"
6580,38,8,30,13799.6312822686,"mid","E"
6581,57,28,29,1028.10919058725,"mid","E"
6582,85,73,12,19670.8355309763,"mid","E"
6583,45,26,19,42182.9730492986,"mid","E"
6584,62,11,51,19187.4276850038,"mid","E"
6585,38,15,23,22061.4860165658,"mid","E"
6586,20,0,20,3666.53183889333,"mid","E"
6587,120,99,21,70627.5274436281,"big","E"
6588,143,15,128,174993.64594126,"big","E"
6589,178,61,117,168918.527401386,"big","E"
6590,158,97,61,185827.212332822,"big","E"
6591,32,1,31,25991.4555745602,"mid","E"
6592,8,5,3,13632.4274132468,"small","E"
6593,135,135,0,223606.894973678,"big","E"
6594,203,106,97,439124.422666933,"big","E"
6595,90,28,62,49478.2151341105,"mid","E"
6596,71,67,4,66619.1396404137,"mid","E"
6597,128,36,92,5825.4796503744,"big","E"
6598,75,17,58,46355.9948290786,"mid","E"
6599,108,70,38,107934.118926572,"big","E"
6600,48,39,9,21138.0159951357,"mid","E"
6601,132,21,111,37043.605186706,"big","E"
6602,164,53,111,135706.16322196,"big","E"
6603,46,2,44,117521.074688217,"mid","E"
6604,58,11,47,134363.986546377,"mid","E"
6605,24,20,4,24387.3498952828,"mid","E"
6606,5,5,0,4241.03178834795,"small","E"
6607,54,42,12,86523.5530213965,"mid","E"
6608,28,18,10,42454.7951383568,"mid","E"
6609,79,4,75,61486.6763907425,"mid","E"
6610,63,39,24,92522.0290784385,"mid","E"
6611,35,22,13,26338.0837083293,"mid","E"
6612,25,14,11,29165.6484170532,"mid","E"
6613,24,8,16,9984.39350705686,"mid","E"
6614,96,95,1,174406.465442084,"mid","E"
6615,2,1,1,3305.00048882591,"small","E"
6616,84,1,83,198236.612579909,"mid","E"
6617,137,113,24,89273.5072893313,"big","E"
6618,95,76,19,100298.330208089,"mid","E"
6619,43,30,13,106539.329604799,"mid","E"
6620,12,0,12,9333.85133787192,"mid","E"
6621,86,58,28,48046.5823270431,"mid","E"
6622,74,4,70,14418.1502639695,"mid","E"
6623,7,2,5,7049.72127816546,"small","E"
6624,2,2,0,1747.80210067722,"small","E"
6625,143,84,59,11249.0418695779,"big","E"
6626,54,3,51,48401.0892910587,"mid","E"
6627,121,56,65,109593.098311765,"big","E"
6628,96,48,48,25442.6896227151,"mid","E"
6629,11,6,5,3005.2902624678,"mid","E"
6630,57,28,29,665.918413943106,"mid","E"
6631,52,20,32,105088.531136089,"mid","E"
6632,141,134,7,265936.973215004,"big","E"
6633,130,63,67,89635.1983743626,"big","E"
6634,118,42,76,45743.4718287269,"big","E"
6635,202,173,29,260058.227164366,"big","E"
6636,18,6,12,41819.001427852,"mid","E"
6637,84,78,6,184926.735140847,"mid","E"
6638,142,86,56,143268.43454462,"big","E"
6639,148,43,105,214402.942295834,"big","E"
6640,26,17,9,18693.2671622444,"mid","E"
6641,96,77,19,62797.5900808846,"mid","E"
6642,170,22,148,222115.953202449,"big","E"
6643,56,42,14,108890.57683543,"mid","E"
6644,99,52,47,725.80341302341,"mid","E"
6645,33,2,31,53281.4971737094,"mid","E"
6646,183,117,66,267758.159602785,"big","E"
6647,10,9,1,15169.0337524264,"small","E"
6648,185,63,122,243164.52244824,"big","E"
6649,9,5,4,14882.4629731116,"small","E"
6650,146,46,100,230042.103167999,"big","E"
6651,89,53,36,193731.181705912,"mid","E"
6652,15,8,7,723.117772607273,"mid","E"
6653,77,27,50,72208.1227133443,"mid","E"
6654,78,3,75,4760.83245097037,"mid","E"
6655,98,6,92,204334.953364657,"mid","E"
6656,63,52,11,36246.1459204041,"mid","E"
6657,9,7,2,3590.41335475617,"small","E"
6658,45,43,2,51296.7175481656,"mid","E"
6659,106,87,19,25724.6220429706,"big","E"
6660,205,155,50,29532.6561119368,"big","E"
6661,10,3,7,178.422713701558,"small","E"
6662,81,32,49,83486.9883573368,"mid","E"
6663,164,56,108,43309.7117394925,"big","E"
6664,85,14,71,41104.9446172996,"mid","E"
6665,48,29,19,39197.6113350439,"mid","E"
6666,155,105,50,72349.9071955162,"big","E"
6667,19,18,1,16422.1966963305,"mid","E"
6668,162,143,19,9953.88256391473,"big","E"
6669,179,29,150,432220.709371071,"big","E"
6670,18,4,14,16908.7511224238,"mid","E"
6671,219,118,101,119633.214961158,"big","E"
6672,136,46,90,48342.6743513562,"big","E"
6673,230,229,1,47984.6628187289,"big","E"
6674,79,31,48,64952.0684851198,"mid","E"
6675,127,74,53,41248.1202053458,"big","E"
6676,115,75,40,103616.575210381,"big","E"
6677,151,86,65,243183.813597323,"big","E"
6678,57,48,9,71473.1372776318,"mid","E"
6679,107,67,40,30962.544817427,"big","E"
6680,81,48,33,10341.4977171139,"mid","E"
6681,30,0,30,4739.84966901989,"mid","E"
6682,30,14,16,968.801516477324,"mid","E"
6683,49,45,4,67953.4483721759,"mid","E"
6684,17,14,3,10305.5462288629,"mid","E"
6685,77,7,70,100594.35404167,"mid","E"
6686,96,63,33,203885.048458285,"mid","E"
6687,41,10,31,40929.8658300576,"mid","E"
6688,17,10,7,24084.9701517035,"mid","E"
6689,168,125,43,48563.1756907084,"big","E"
6690,100,56,44,134068.284235972,"mid","E"
6691,127,90,37,16129.8616803983,"big","E"
6692,164,131,33,470266.921177399,"big","E"
6693,23,16,7,2010.23543494704,"mid","E"
6694,242,12,230,226400.102400155,"big","E"
6695,75,69,6,109227.423019008,"mid","E"
6696,19,17,2,35409.3597179681,"mid","E"
6697,51,39,12,44477.3612846471,"mid","E"
6698,110,108,2,25911.9396456374,"big","E"
6699,43,17,26,93587.6964066955,"mid","E"
6700,344,173,171,208028.506581875,"big","E"
6701,73,64,9,99640.3980801011,"mid","E"
6702,23,17,6,32208.833678089,"mid","E"
6703,151,127,24,143795.256388866,"big","E"
6704,62,1,61,36715.141020562,"mid","E"
6705,2,2,0,943.444443199196,"small","E"
6706,73,30,43,43638.8823864127,"mid","E"
6707,146,40,106,121335.618906486,"big","E"
6708,52,27,25,127510.522652437,"mid","E"
6709,39,7,32,32152.2263479689,"mid","E"
6710,47,37,10,24143.9574029862,"mid","E"
6711,23,12,11,19495.1168421447,"mid","E"
6712,26,14,12,44913.3604010441,"mid","E"
6713,183,174,9,203478.318208643,"big","E"
6714,142,89,53,104796.210974052,"big","E"
6715,81,19,62,63646.9283941647,"mid","E"
6716,127,33,94,265306.928035246,"big","E"
6717,64,32,32,143951.774362907,"mid","E"
6718,76,11,65,18648.1241928228,"mid","E"
6719,66,12,54,33975.6795463559,"mid","E"
6720,37,13,24,20576.7531108069,"mid","E"
6721,55,37,18,49245.435163346,"mid","E"
6722,86,8,78,38651.7351146111,"mid","E"
6723,33,28,5,76.4590949345555,"mid","E"
6724,66,53,13,23309.9258487199,"mid","E"
6725,75,65,10,248743.231362932,"mid","E"
6726,92,39,53,12780.1368236612,"mid","E"
6727,27,10,17,21320.9557994589,"mid","E"
6728,27,19,8,12125.7703397714,"mid","E"
6729,44,17,27,48370.3463400911,"mid","E"
6730,105,43,62,200456.036372289,"big","E"
6731,49,19,30,28019.7981852842,"mid","E"
6732,22,9,13,35571.7841731545,"mid","E"
6733,135,71,64,281316.839444361,"big","E"
6734,40,39,1,120540.832434509,"mid","E"
6735,63,27,36,130816.847740091,"mid","E"
6736,20,18,2,27846.0126355997,"mid","E"
6737,62,48,14,80600.8655220156,"mid","E"
6738,7,7,0,6489.73878969651,"small","E"
6739,10,8,2,3110.4776829489,"small","E"
6740,308,206,102,156090.498569154,"big","E"
6741,87,5,82,265454.290865688,"mid","E"
6742,96,95,1,179419.450127096,"mid","E"
6743,124,16,108,213538.693849962,"big","E"
6744,43,30,13,28210.1163518364,"mid","E"
6745,126,121,5,53122.8380804005,"big","E"
6746,84,3,81,70805.1281106536,"mid","E"
6747,16,4,12,9867.2409695449,"mid","E"
6748,33,12,21,25463.9507817122,"mid","E"
6749,36,24,12,51280.8989820806,"mid","E"
6750,20,16,4,22651.3711098733,"mid","E"
6751,22,17,5,13204.5249702486,"mid","E"
6752,40,1,39,95041.4299094483,"mid","E"
6753,207,84,123,277665.700456849,"big","E"
6754,71,55,16,133122.66164226,"mid","E"
6755,57,29,28,150053.736844522,"mid","E"
6756,51,11,40,89200.1164530112,"mid","E"
6757,14,1,13,24855.2406235353,"mid","E"
6758,48,26,22,47863.0725944783,"mid","E"
6759,30,8,22,25196.4633216353,"mid","E"
6760,194,27,167,197763.543964923,"big","E"
6761,169,145,24,385013.315551654,"big","E"
6762,61,22,39,161402.581931863,"mid","E"
6763,129,90,39,3808.52289537342,"big","E"
6764,56,47,9,3856.26995414777,"mid","E"
6765,112,34,78,120691.89675053,"big","E"
6766,101,9,92,155879.163088704,"big","E"
6767,52,11,41,28590.0780656523,"mid","E"
6768,51,26,25,60335.9090272655,"mid","E"
6769,16,9,7,4036.51609699226,"mid","E"
6770,177,83,94,174116.20023052,"big","E"
6771,140,20,120,357955.704030019,"big","E"
6772,50,3,47,53882.0422893796,"mid","E"
6773,62,20,42,6975.49030601505,"mid","E"
6774,51,20,31,63859.4248845131,"mid","E"
6775,107,47,60,23359.3203237072,"big","E"
6776,2,1,1,1260.60302378013,"small","E"
6777,100,65,35,1704.17643489635,"mid","E"
6778,44,32,12,47976.4864531475,"mid","E"
6779,28,25,3,30745.3651527968,"mid","E"
6780,154,20,134,38430.1886290928,"big","E"
6781,6,3,3,10632.2098115095,"small","E"
6782,60,18,42,9839.05192303408,"mid","E"
6783,215,194,21,1746.25532969941,"big","E"
6784,51,20,31,105806.204337712,"mid","E"
6785,54,32,22,35598.2753223307,"mid","E"
6786,125,75,50,78010.7473007966,"big","E"
6787,94,0,94,118346.696415362,"mid","E"
6788,32,32,0,76895.0173547267,"mid","E"
6789,74,4,70,190913.548152771,"mid","E"
6790,8,4,4,15738.3287590396,"small","E"
6791,150,95,55,89434.031678196,"big","E"
6792,23,1,22,31661.4986708364,"mid","E"
6793,78,32,46,140384.045515893,"mid","E"
6794,210,102,108,43737.2338829375,"big","E"
6795,94,76,18,21709.8103073935,"mid","E"
6796,45,29,16,12770.8740257153,"mid","E"
6797,123,107,16,37169.7210089096,"big","E"
6798,77,11,66,102691.336141687,"mid","E"
6799,107,59,48,140005.179740064,"big","E"
6800,57,32,25,93571.7176501596,"mid","E"
6801,58,44,14,119523.980378385,"mid","E"
6802,113,36,77,91355.9130316945,"big","E"
6803,88,56,32,40847.4479361128,"mid","E"
6804,126,32,94,158594.861109139,"big","E"
6805,173,72,101,231411.133287926,"big","E"
6806,6,5,1,1791.24217835761,"small","E"
6807,95,67,28,74634.8210014565,"mid","E"
6808,121,29,92,68325.7429303419,"big","E"
6809,41,4,37,37509.7844454845,"mid","E"
6810,81,77,4,61135.3778496198,"mid","E"
6811,236,47,189,155028.317751882,"big","E"
6812,34,8,26,65019.1927347922,"mid","E"
6813,26,18,8,11910.0453328836,"mid","E"
6814,100,33,67,356173.171802392,"mid","E"
6815,106,37,69,124371.994000394,"big","E"
6816,8,1,7,15424.3566044175,"small","E"
6817,6,0,6,365.121461046309,"small","E"
6818,20,15,5,41102.7116936417,"mid","E"
6819,93,80,13,61261.7662489178,"mid","E"
6820,19,2,17,17469.3414757862,"mid","E"
6821,58,18,40,16376.5327740413,"mid","E"
6822,9,1,8,5671.18246476986,"small","E"
6823,36,22,14,68088.2344188309,"mid","E"
6824,93,84,9,153925.264706962,"mid","E"
6825,31,23,8,15752.2606815782,"mid","E"
6826,116,50,66,201763.016205175,"big","E"
6827,83,77,6,2909.43288261084,"mid","E"
6828,80,63,17,57941.2184533955,"mid","E"
6829,11,3,8,9256.31993563328,"mid","E"
6830,166,79,87,150851.288762618,"big","E"
6831,173,75,98,361276.860299461,"big","E"
6832,33,11,22,86479.3135661026,"mid","E"
6833,25,17,8,7018.81388499377,"mid","E"
6834,23,2,21,9413.81661138787,"mid","E"
6835,41,9,32,159007.896883152,"mid","E"
6836,22,8,14,19692.4046676459,"mid","E"
6837,190,126,64,118725.242221917,"big","E"
6838,163,25,138,261332.324611305,"big","E"
6839,25,13,12,39074.2992899551,"mid","E"
6840,111,105,6,8546.88219709667,"big","E"
6841,40,39,1,44309.5416764959,"mid","E"
6842,100,99,1,205103.645517693,"mid","E"
6843,147,33,114,243679.158090309,"big","E"
6844,21,14,7,22577.0491738163,"mid","E"
6845,31,19,12,15837.3831488641,"mid","E"
6846,37,28,9,69351.0738774232,"mid","E"
6847,64,27,37,115584.885417911,"mid","E"
6848,105,76,29,9464.82519197889,"big","E"
6849,130,105,25,153264.172458312,"big","E"
6850,92,19,73,22176.5395245971,"mid","E"
6851,162,46,116,110021.711856989,"big","E"
6852,63,50,13,361.682579652401,"mid","E"
6853,34,24,10,11588.0069687652,"mid","E"
6854,86,6,80,180812.667411966,"mid","E"
6855,43,13,30,37262.4729305258,"mid","E"
6856,59,33,26,116099.226451087,"mid","E"
6857,99,89,10,198227.879599148,"mid","E"
6858,70,6,64,194213.306392609,"mid","E"
6859,53,3,50,5320.00025831814,"mid","E"
6860,41,21,20,46366.0993840417,"mid","E"
6861,103,10,93,228893.176268724,"big","E"
6862,44,1,43,5053.5773661488,"mid","E"
6863,71,53,18,72147.7545093288,"mid","E"
6864,58,11,47,21879.4504023241,"mid","E"
6865,70,64,6,34316.059952254,"mid","E"
6866,31,18,13,2338.29114239673,"mid","E"
6867,19,6,13,32375.2324549364,"mid","E"
6868,150,120,30,458336.366782075,"big","E"
6869,56,32,24,19773.5071712868,"mid","E"
6870,51,24,27,30621.4794190825,"mid","E"
6871,104,44,60,86260.7005048757,"big","E"
6872,92,56,36,110955.798908041,"mid","E"
6873,52,23,29,29473.5172205703,"mid","E"
6874,237,140,97,474188.6764188,"big","E"
6875,66,24,42,42258.8196121454,"mid","E"
6876,46,11,35,106666.169016684,"mid","E"
6877,78,19,59,52556.889548817,"mid","E"
6878,93,6,87,304899.80989635,"mid","E"
6879,101,19,82,5136.49177667288,"big","E"
6880,114,84,30,239266.675128465,"big","E"
6881,50,34,16,140384.931660425,"mid","E"
6882,7,3,4,6732.62635845358,"small","E"
6883,180,41,139,213808.38710999,"big","E"
6884,119,29,90,94733.902350459,"big","E"
6885,107,70,37,23729.7332584486,"big","E"
6886,210,132,78,204541.744264919,"big","E"
6887,46,38,8,138934.547916347,"mid","E"
6888,30,29,1,68709.1989643538,"mid","E"
6889,62,42,20,45308.0362413342,"mid","E"
6890,123,10,113,185181.937784007,"big","E"
6891,2,1,1,798.532247741224,"small","E"
6892,97,76,21,67769.5186832512,"mid","E"
6893,81,34,47,882.143841570013,"mid","E"
6894,19,6,13,63201.4223376923,"mid","E"
6895,16,4,12,9461.73713277447,"mid","E"
6896,59,5,54,14009.7848938942,"mid","E"
6897,45,18,27,23600.9980929098,"mid","E"
6898,110,53,57,130550.451917303,"big","E"
6899,234,169,65,102775.79781927,"big","E"
6900,160,50,110,310797.982443095,"big","E"
6901,154,0,154,192841.695071943,"big","E"
6902,16,3,13,2848.21988207234,"mid","E"
6903,114,22,92,171767.609308372,"big","E"
6904,66,29,37,77722.3992178235,"mid","E"
6905,15,10,5,24037.505107947,"mid","E"
6906,87,17,70,23362.0336522604,"mid","E"
6907,134,7,127,11213.3608033513,"big","E"
6908,23,3,20,12609.4866535955,"mid","E"
6909,17,15,2,25694.2398341782,"mid","E"
6910,130,79,51,45838.9295986584,"big","E"
6911,19,2,17,29548.5990242004,"mid","E"
6912,91,52,39,51349.967451517,"mid","E"
6913,118,53,65,115422.42286832,"big","E"
6914,119,102,17,167623.26775235,"big","E"
6915,15,9,6,11972.4641792377,"mid","E"
6916,37,1,36,26531.0515344548,"mid","E"
6917,71,11,60,45929.3026079028,"mid","E"
6918,142,140,2,68181.8601627833,"big","E"
6919,21,11,10,22539.5228410651,"mid","E"
6920,45,21,24,18093.6415217431,"mid","E"
6921,40,40,0,86619.874122131,"mid","E"
6922,36,29,7,86469.8595378938,"mid","E"
6923,89,60,29,176183.86086191,"mid","E"
6924,11,9,2,9448.96341254484,"mid","E"
6925,121,53,68,163029.474700446,"big","E"
6926,156,15,141,234047.736432587,"big","E"
6927,133,102,31,177938.193211752,"big","E"
6928,190,88,102,1078.89855123803,"big","E"
6929,172,54,118,5980.7022054728,"big","E"
6930,124,93,31,307990.19560834,"big","E"
6931,50,3,47,12186.2430358912,"mid","E"
6932,291,39,252,239806.014741884,"big","E"
6933,67,66,1,63706.6957008993,"mid","E"
6934,11,7,4,1107.97201654986,"mid","E"
6935,177,32,145,441310.024771909,"big","E"
6936,177,147,30,170518.971197424,"big","E"
6937,67,34,33,66890.5621169598,"mid","E"
6938,68,25,43,113035.471358985,"mid","E"
6939,92,78,14,228965.96472014,"mid","E"
6940,174,95,79,51531.7647094221,"big","E"
6941,190,190,0,231823.464392764,"big","E"
6942,165,20,145,27557.3926414296,"big","E"
6943,122,1,121,136739.425660013,"big","E"
6944,6,1,5,96.8880298743411,"small","E"
6945,1,0,1,2233.20859976229,"small","E"
6946,27,22,5,23815.1827186599,"mid","E"
6947,24,3,21,26482.3490732377,"mid","E"
6948,70,40,30,120005.174287057,"mid","E"
6949,133,85,48,23150.4216514976,"big","E"
6950,4,4,0,3048.40167605714,"small","E"
6951,12,2,10,23086.0957831476,"mid","E"
6952,106,7,99,232264.864744287,"big","E"
6953,73,22,51,105628.790412451,"mid","E"
6954,51,2,49,13899.8780098303,"mid","E"
6955,154,76,78,198845.450196492,"big","E"
6956,135,2,133,30017.8935567915,"big","E"
6957,92,26,66,8911.93998777272,"mid","E"
6958,44,40,4,37835.9019147543,"mid","E"
6959,65,11,54,74447.2632856194,"mid","E"
6960,162,111,51,27393.5064063241,"big","E"
6961,16,2,14,25393.6412532675,"mid","E"
6962,17,16,1,4163.87978038689,"mid","E"
6963,125,55,70,55425.1283598217,"big","E"
6964,188,97,91,34453.9570042728,"big","E"
6965,44,11,33,7662.24396385514,"mid","E"
6966,34,1,33,38233.5575491105,"mid","E"
6967,59,13,46,45650.2141864635,"mid","E"
6968,71,12,59,131030.404943019,"mid","E"
6969,29,2,27,48499.6527301475,"mid","E"
6970,66,66,0,8764.75810026007,"mid","E"
6971,42,23,19,47702.2084111416,"mid","E"
6972,97,88,9,74778.289233384,"mid","E"
6973,8,1,7,7477.20456274956,"small","E"
6974,218,167,51,145981.6981473,"big","E"
6975,92,39,53,283277.668522486,"mid","E"
6976,32,10,22,34938.5769430108,"mid","E"
6977,106,63,43,178597.889598638,"big","E"
6978,177,155,22,235163.888677814,"big","E"
6979,73,60,13,126680.186095322,"mid","E"
6980,115,45,70,52758.4359371436,"big","E"
6981,159,63,96,50637.9824642853,"big","E"
6982,5,2,3,1244.61203165946,"small","E"
6983,10,9,1,20705.709060219,"small","E"
6984,62,39,23,145437.606001008,"mid","E"
6985,27,20,7,43499.5067946087,"mid","E"
6986,81,55,26,141458.524117841,"mid","E"
6987,5,2,3,13845.9924756464,"small","E"
6988,126,65,61,122130.079408556,"big","E"
6989,63,29,34,8218.15507172048,"mid","E"
6990,110,95,15,155519.339101876,"big","E"
6991,215,141,74,283800.429691667,"big","E"
6992,99,10,89,44925.1439594097,"mid","E"
6993,41,14,27,68425.0631197719,"mid","E"
6994,20,7,13,26558.1733559256,"mid","E"
6995,122,117,5,68724.3907860348,"big","E"
6996,79,67,12,98828.5091790572,"mid","E"
6997,30,22,8,32884.8796578108,"mid","E"
6998,63,5,58,11587.7050958182,"mid","E"
6999,21,12,9,7330.60626565736,"mid","E"
7000,107,9,98,34582.2398613956,"big","E"
7001,167,23,144,77484.6160968389,"big","E"
7002,78,19,59,175532.803024613,"mid","E"
7003,8,6,2,12123.1506137917,"small","E"
7004,188,49,139,131429.255926867,"big","E"
7005,59,47,12,76226.1069301638,"mid","E"
7006,128,73,55,171629.921643863,"big","E"
7007,9,8,1,10057.5679754125,"small","E"
7008,41,24,17,74882.0558135905,"mid","E"
7009,23,15,8,43959.5434823482,"mid","E"
7010,221,166,55,753112.789221189,"big","E"
7011,56,37,19,56801.688766798,"mid","E"
7012,6,6,0,10764.9591639784,"small","E"
7013,153,41,112,185825.19147925,"big","E"
7014,67,49,18,59441.1097530073,"mid","E"
7015,110,103,7,116138.839946087,"big","E"
7016,121,32,89,73631.9514620454,"big","E"
7017,58,27,31,10584.1370842066,"mid","E"
7018,84,74,10,53441.731065601,"mid","E"
7019,66,19,47,88944.5268623045,"mid","E"
7020,2,1,1,1465.72627473434,"small","E"
7021,5,2,3,7254.39948085848,"small","E"
7022,73,48,25,101526.941160138,"mid","E"
7023,109,78,31,199749.530065867,"big","E"
7024,153,93,60,293612.9048293,"big","E"
7025,32,23,9,53168.150464167,"mid","E"
7026,78,28,50,71892.3141264422,"mid","E"
7027,82,15,67,28691.7352806201,"mid","E"
7028,15,2,13,51133.7385040453,"mid","E"
7029,170,92,78,28633.3104556129,"big","E"
7030,149,43,106,402922.814674376,"big","E"
7031,77,52,25,103948.303682179,"mid","E"
7032,45,19,26,59395.8823242037,"mid","E"
7033,70,12,58,18740.9686427137,"mid","E"
7034,152,135,17,311819.128750029,"big","E"
7035,97,65,32,127905.351923109,"mid","E"
7036,25,17,8,26710.7399588334,"mid","E"
7037,86,65,21,174000.212028832,"mid","E"
7038,100,49,51,161643.005585138,"mid","E"
7039,120,74,46,10280.2330150188,"big","E"
7040,43,15,28,54501.2908496304,"mid","E"
7041,70,27,43,72794.4866627115,"mid","E"
7042,158,157,1,326993.982644243,"big","E"
7043,78,14,64,195869.207166969,"mid","E"
7044,135,106,29,471025.139580522,"big","E"
7045,20,9,11,15366.8355448921,"mid","E"
7046,35,14,21,41016.8383699339,"mid","E"
7047,171,16,155,156699.74155985,"big","E"
7048,50,4,46,130656.068945632,"mid","E"
7049,21,9,12,39482.284749513,"mid","E"
7050,187,97,90,233429.302326574,"big","E"
7051,82,2,80,225742.620541629,"mid","E"
7052,42,6,36,18152.5485175502,"mid","E"
7053,8,3,5,13988.7089224595,"small","E"
7054,62,29,33,73831.3940051957,"mid","E"
7055,48,15,33,19976.509096908,"mid","E"
7056,116,108,8,16863.8720615642,"big","E"
7057,56,19,37,60234.7005388969,"mid","E"
7058,163,20,143,320107.355203325,"big","E"
7059,47,45,2,64326.7777293756,"mid","E"
7060,26,16,10,52412.0803387458,"mid","E"
7061,45,29,16,6176.64121151057,"mid","E"
7062,153,89,64,212.276951723063,"big","E"
7063,176,30,146,3949.10753541291,"big","E"
7064,36,34,2,37810.0152632886,"mid","E"
7065,86,62,24,122839.445448653,"mid","E"
7066,75,50,25,150613.234134191,"mid","E"
7067,1,1,0,406.715931018632,"small","E"
7068,139,32,107,101696.607502284,"big","E"
7069,188,142,46,89266.5578971046,"big","E"
7070,60,28,32,185175.411087965,"mid","E"
7071,57,50,7,38842.9036363695,"mid","E"
7072,128,62,66,25502.468130809,"big","E"
7073,17,15,2,4886.69105766269,"mid","E"
7074,65,33,32,62398.7766229977,"mid","E"
7075,84,47,37,58103.8076412617,"mid","E"
7076,23,17,6,33824.4581294444,"mid","E"
7077,90,76,14,114797.060763836,"mid","E"
7078,30,19,11,28640.5025944416,"mid","E"
7079,75,63,12,164888.265313298,"mid","E"
7080,12,1,11,4021.38654403448,"mid","E"
7081,15,14,1,12979.2753738982,"mid","E"
7082,43,14,29,11736.5085922223,"mid","E"
7083,21,6,15,34022.7398321284,"mid","E"
7084,178,31,147,6012.00886260249,"big","E"
7085,124,55,69,134292.753305031,"big","E"
7086,161,148,13,151064.83365387,"big","E"
7087,40,26,14,66859.1635209032,"mid","E"
7088,50,36,14,77758.2360691779,"mid","E"
7089,179,39,140,311930.527440439,"big","E"
7090,148,1,147,62634.9148598706,"big","E"
7091,111,72,39,17671.1933072867,"big","E"
7092,133,10,123,318508.890581755,"big","E"
7093,238,118,120,358565.971589142,"big","E"
7094,52,30,22,11889.6853907695,"mid","E"
7095,179,118,61,255685.032574485,"big","E"
7096,46,41,5,67559.3540910756,"mid","E"
7097,125,76,49,41985.3295075795,"big","E"
7098,141,9,132,154576.717377884,"big","E"
7099,108,47,61,113557.529087029,"big","E"
7100,157,75,82,88206.7791864783,"big","E"
7101,75,12,63,40680.882187585,"mid","E"
7102,55,3,52,76800.8207093252,"mid","E"
7103,23,11,12,10953.6514490462,"mid","E"
7104,105,67,38,27618.6966117211,"big","E"
7105,11,11,0,9730.38801920248,"mid","E"
7106,135,104,31,298148.529206194,"big","E"
7107,2,0,2,944.475744985436,"small","E"
7108,9,4,5,12712.4123601264,"small","E"
7109,3,1,2,2927.36430712432,"small","E"
7110,60,39,21,18476.0997055655,"mid","E"
7111,29,27,2,35677.8165391699,"mid","E"
7112,25,23,2,17910.6799980631,"mid","E"
7113,81,46,35,20356.0795859394,"mid","E"
7114,58,16,42,26092.6956283508,"mid","E"
7115,5,3,2,8918.72222086944,"small","E"
7116,130,113,17,24581.1483421243,"big","E"
7117,236,111,125,65100.5691567807,"big","E"
7118,54,40,14,62885.6067450729,"mid","E"
7119,72,7,65,28622.0460273985,"mid","E"
7120,27,11,16,56528.8414477805,"mid","E"
7121,107,20,87,53863.0136884329,"big","E"
7122,40,7,33,3779.22672651832,"mid","E"
7123,31,20,11,767.317740821751,"mid","E"
7124,54,3,51,78861.9690870841,"mid","E"
7125,49,47,2,136910.555127885,"mid","E"
7126,25,24,1,5442.49929600433,"mid","E"
7127,234,108,126,441143.954737464,"big","E"
7128,61,24,37,55171.951964672,"mid","E"
7129,230,214,16,446537.581849525,"big","E"
7130,161,129,32,240574.136705128,"big","E"
7131,181,145,36,50754.0254002183,"big","E"
7132,22,11,11,2336.14330911295,"mid","E"
7133,147,41,106,131528.005170148,"big","E"
7134,1,0,1,1064.91692577623,"small","E"
7135,66,37,29,136202.413377119,"mid","E"
7136,7,4,3,10277.8083829582,"small","E"
7137,116,20,96,331303.77633092,"big","E"
7138,99,88,11,135780.94371574,"mid","E"
7139,19,2,17,36674.5793558893,"mid","E"
7140,14,12,2,17983.6239073651,"mid","E"
7141,32,12,20,41602.6976625645,"mid","E"
7142,58,11,47,45337.8702359055,"mid","E"
7143,84,52,32,67148.3637360237,"mid","E"
7144,14,10,4,2467.42857305496,"mid","E"
7145,92,82,10,56677.8357998541,"mid","E"
7146,82,19,63,122923.92982198,"mid","E"
7147,114,31,83,90217.2051273801,"big","E"
7148,185,140,45,113316.938141567,"big","E"
7149,7,5,2,16709.9016430117,"small","E"
7150,3,2,1,2639.05237088218,"small","E"
7151,7,1,6,1150.5800379314,"small","E"
7152,145,118,27,269060.946063632,"big","E"
7153,15,5,10,50452.5074246484,"mid","E"
7154,142,74,68,235776.016714297,"big","E"
7155,92,36,56,69190.4639441081,"mid","E"
7156,68,47,21,1630.19165305427,"mid","E"
7157,75,19,56,52254.144647286,"mid","E"
7158,106,105,1,40793.7206056467,"big","E"
7159,139,34,105,86955.8295820818,"big","E"
7160,44,28,16,53418.0599455783,"mid","E"
7161,135,59,76,67797.4332342274,"big","E"
7162,278,253,25,827401.740673625,"big","E"
7163,12,6,6,12233.8949189966,"mid","E"
7164,212,200,12,207699.006322602,"big","E"
7165,182,45,137,224381.976493311,"big","E"
7166,32,27,5,70524.5100350767,"mid","E"
7167,223,188,35,6950.37573400438,"big","E"
7168,79,75,4,51127.7010446014,"mid","E"
7169,63,4,59,124948.925465139,"mid","E"
7170,24,2,22,15193.557755738,"mid","E"
7171,94,37,57,181466.118361887,"mid","E"
7172,106,83,23,222465.114404812,"big","E"
7173,6,5,1,8030.21956986963,"small","E"
7174,18,9,9,26258.9737199915,"mid","E"
7175,47,19,28,720.855584467801,"mid","E"
7176,162,33,129,151838.536353014,"big","E"
7177,147,89,58,41884.0241404175,"big","E"
7178,45,10,35,22691.3665299319,"mid","E"
7179,36,21,15,120192.166962353,"mid","E"
7180,102,100,2,60630.6042630483,"big","E"
7181,146,123,23,286908.737050121,"big","E"
7182,57,38,19,10584.5475478042,"mid","E"
7183,9,1,8,9009.02275227771,"small","E"
7184,8,2,6,12595.6082008714,"small","E"
7185,13,5,8,21404.4361867326,"mid","E"
7186,29,6,23,4275.02244185505,"mid","E"
7187,66,4,62,79479.3437535097,"mid","E"
7188,124,88,36,202927.924248086,"big","E"
7189,61,54,7,56760.6379081212,"mid","E"
7190,6,2,4,5318.33829437492,"small","E"
7191,81,51,30,165601.352928703,"mid","E"
7192,53,44,9,9715.19499622477,"mid","E"
7193,73,28,45,100510.921420939,"mid","E"
7194,40,30,10,8465.29269853967,"mid","E"
7195,190,187,3,123353.078770373,"big","E"
7196,42,15,27,50677.0961543734,"mid","E"
7197,84,84,0,99544.5451971809,"mid","E"
7198,133,129,4,46584.1613050269,"big","E"
7199,52,2,50,181777.702237346,"mid","E"
7200,140,67,73,149025.000050389,"big","E"
7201,45,26,19,23186.4730362356,"mid","E"
7202,73,71,2,33412.0391445159,"mid","E"
7203,60,42,18,149886.048365624,"mid","E"
7204,48,29,19,43543.9189938971,"mid","E"
7205,135,42,93,10366.0693901446,"big","E"
7206,86,49,37,54304.9603001124,"mid","E"
7207,100,100,0,228512.180224242,"mid","E"
7208,1,1,0,3238.82111794001,"small","E"
7209,265,199,66,78756.3210263391,"big","E"
7210,147,31,116,35109.2011934115,"big","E"
7211,27,22,5,29218.8245900396,"mid","E"
7212,119,27,92,143571.291156456,"big","E"
7213,109,3,106,93562.163059098,"big","E"
7214,74,32,42,170547.94045217,"mid","E"
7215,54,37,17,4487.75410270232,"mid","E"
7216,99,48,51,83015.5916971884,"mid","E"
7217,40,24,16,13445.0796747163,"mid","E"
7218,31,5,26,6439.83189515195,"mid","E"
7219,69,14,55,78378.0153690058,"mid","E"
7220,27,14,13,41841.6289322505,"mid","E"
7221,95,64,31,46658.6156477973,"mid","E"
7222,38,19,19,26900.2800335268,"mid","E"
7223,136,111,25,117167.469276347,"big","E"
7224,1,0,1,131.720961233054,"small","E"
7225,194,189,5,337743.707644185,"big","E"
7226,114,97,17,69631.8458686327,"big","E"
7227,66,51,15,141160.337203133,"mid","E"
7228,159,86,73,178566.84202985,"big","E"
7229,99,10,89,124553.86510231,"mid","E"
7230,70,44,26,133360.342147158,"mid","E"
7231,1,1,0,208.625779102993,"small","E"
7232,23,16,7,4267.86720357602,"mid","E"
7233,22,11,11,29064.364812035,"mid","E"
7234,31,8,23,31632.4541728526,"mid","E"
7235,19,10,9,23251.6415432184,"mid","E"
7236,92,44,48,130418.348020621,"mid","E"
7237,52,25,27,10339.6598122472,"mid","E"
7238,182,98,84,82754.4436209574,"big","E"
7239,129,20,109,236223.028097462,"big","E"
7240,98,90,8,317401.724602833,"mid","E"
7241,150,126,24,413554.456539485,"big","E"
7242,70,57,13,152603.896679813,"mid","E"
7243,72,26,46,48593.6073011841,"mid","E"
7244,8,7,1,10481.723578589,"small","E"
7245,6,4,2,17698.5113144842,"small","E"
7246,249,42,207,102970.245341776,"big","E"
7247,85,33,52,112672.070756395,"mid","E"
7248,77,29,48,221274.093016589,"mid","E"
7249,87,44,43,72180.4343690105,"mid","E"
7250,4,1,3,6153.29094994182,"small","E"
7251,45,10,35,65975.5692463168,"mid","E"
7252,13,11,2,5643.79536563554,"mid","E"
7253,96,22,74,12796.4970366775,"mid","E"
7254,6,3,3,11556.3509229442,"small","E"
7255,114,103,11,96931.8562304793,"big","E"
7256,247,182,65,431874.391195331,"big","E"
7257,23,23,0,70530.7326697106,"mid","E"
7258,1,1,0,1307.92774567491,"small","E"
7259,217,209,8,283072.483795481,"big","E"
7260,112,10,102,7278.54372508994,"big","E"
7261,15,9,6,4830.7038052218,"mid","E"
7262,47,12,35,65006.1416013081,"mid","E"
7263,12,11,1,13660.3316666982,"mid","E"
7264,62,19,43,113527.991054306,"mid","E"
7265,247,226,21,219358.228540439,"big","E"
7266,14,4,10,20843.3741616206,"mid","E"
7267,10,5,5,1350.26380604054,"small","E"
7268,20,10,10,1212.27363735668,"mid","E"
7269,85,83,2,105074.821182378,"mid","E"
7270,244,163,81,309214.632588897,"big","E"
7271,187,109,78,34645.9826362819,"big","E"
7272,20,19,1,17156.1640972002,"mid","E"
7273,142,6,136,23110.4916477692,"big","E"
7274,20,5,15,10804.7824192252,"mid","E"
7275,75,72,3,51222.9367472396,"mid","E"
7276,221,127,94,173239.980407028,"big","E"
7277,56,53,3,163647.949774553,"mid","E"
7278,36,31,5,17551.0817504654,"mid","E"
7279,60,58,2,9853.51709879091,"mid","E"
7280,150,48,102,20082.7627661628,"big","E"
7281,142,122,20,196110.678732337,"big","E"
7282,268,250,18,63458.672902089,"big","E"
7283,4,4,0,806.156862688677,"small","E"
7284,49,25,24,33193.0107044383,"mid","E"
7285,179,169,10,47389.6842425374,"big","E"
7286,5,0,5,7916.58285795004,"small","E"
7287,188,165,23,409011.726175222,"big","E"
7288,57,17,40,49374.7329465005,"mid","E"
7289,49,47,2,43711.9747162314,"mid","E"
7290,91,61,30,222766.35565236,"mid","E"
7291,97,70,27,32149.6858611532,"mid","E"
7292,41,12,29,76297.5755620686,"mid","E"
7293,27,18,9,23970.0784160157,"mid","E"
7294,13,11,2,2340.20958132108,"mid","E"
7295,93,64,29,218817.143707463,"mid","E"
7296,51,15,36,2873.85074346398,"mid","E"
7297,11,0,11,5755.56506265242,"mid","E"
7298,39,10,29,81033.1580618182,"mid","E"
7299,83,11,72,97906.0060966185,"mid","E"
7300,78,40,38,134250.61637411,"mid","E"
7301,12,9,3,27623.854085451,"mid","E"
7302,139,100,39,88984.0111163323,"big","E"
7303,2,1,1,6838.36878241887,"small","E"
7304,230,151,79,560427.497791629,"big","E"
7305,126,120,6,178883.777503646,"big","E"
7306,20,14,6,24701.2629038246,"mid","E"
7307,192,147,45,131191.913056598,"big","E"
7308,100,52,48,107755.712702861,"mid","E"
7309,95,26,69,238001.266168017,"mid","E"
7310,23,18,5,19750.6330801972,"mid","E"
7311,133,112,21,74646.004687896,"big","E"
7312,81,3,78,148173.922127796,"mid","E"
7313,102,25,77,272913.309374927,"big","E"
7314,97,34,63,181765.127246852,"mid","E"
7315,4,4,0,3102.16552858931,"small","E"
7316,105,69,36,111929.869572157,"big","E"
7317,66,15,51,15445.4091054818,"mid","E"
7318,110,19,91,15946.649981015,"big","E"
7319,275,113,162,410472.526783283,"big","E"
7320,104,64,40,78547.8946795893,"big","E"
7321,82,77,5,206422.008815485,"mid","E"
7322,101,6,95,41227.7629902534,"big","E"
7323,11,11,0,27919.0954477154,"mid","E"
7324,30,29,1,13222.6452148583,"mid","E"
7325,9,7,2,2810.7987317257,"small","E"
7326,230,222,8,470013.512761735,"big","E"
7327,23,6,17,1412.25162864176,"mid","E"
7328,12,7,5,11093.4224003198,"mid","E"
7329,103,84,19,64892.6531762292,"big","E"
7330,81,25,56,52508.0625210607,"mid","E"
7331,30,10,20,73670.2730771195,"mid","E"
7332,3,1,2,5918.66601537636,"small","E"
7333,4,2,2,5788.06322650045,"small","E"
7334,77,64,13,182829.543638767,"mid","E"
7335,57,13,44,12818.5955206659,"mid","E"
7336,10,3,7,17003.0299542827,"small","E"
7337,11,11,0,27775.9362998846,"mid","E"
7338,251,164,87,100369.458223463,"big","E"
7339,25,2,23,8217.94801179771,"mid","E"
7340,92,88,4,8590.39871903509,"mid","E"
7341,137,114,23,151183.195169439,"big","E"
7342,160,144,16,21177.4350661484,"big","E"
7343,152,133,19,286775.061724223,"big","E"
7344,23,17,6,19143.2429814339,"mid","E"
7345,72,61,11,107015.050991441,"mid","E"
7346,127,122,5,1623.83680099125,"big","E"
7347,94,61,33,58565.6881355336,"mid","E"
7348,153,4,149,13410.8707827663,"big","E"
7349,96,90,6,202961.791121166,"mid","E"
7350,238,70,168,238956.358988358,"big","E"
7351,13,7,6,726.426302697748,"mid","E"
7352,73,12,61,184600.29564268,"mid","E"
7353,65,18,47,100328.692994462,"mid","E"
7354,73,54,19,22626.1232158188,"mid","E"
7355,183,183,0,267511.978069923,"big","E"
7356,37,7,30,97766.2025088502,"mid","E"
7357,45,41,4,74253.8031466699,"mid","E"
7358,89,40,49,69264.0763954591,"mid","E"
7359,134,53,81,162498.742598693,"big","E"
7360,55,38,17,134987.569524843,"mid","E"
7361,90,80,10,61371.9285737326,"mid","E"
7362,63,40,23,89354.1262798254,"mid","E"
7363,71,3,68,229788.788952015,"mid","E"
7364,48,41,7,3196.25081145193,"mid","E"
7365,50,42,8,71599.3086662137,"mid","E"
7366,49,44,5,54063.6753087124,"mid","E"
7367,86,85,1,49549.1337458163,"mid","E"
7368,56,8,48,85526.0449669508,"mid","E"
7369,89,83,6,76598.6870503128,"mid","E"
7370,40,3,37,34089.6219593652,"mid","E"
7371,15,2,13,43367.8499515521,"mid","E"
7372,48,15,33,111708.118274767,"mid","E"
7373,27,25,2,7217.54422005484,"mid","E"
7374,42,13,29,102928.618164792,"mid","E"
7375,173,67,106,5245.37008290581,"big","E"
7376,125,82,43,109327.20757864,"big","E"
7377,9,4,5,8049.29035585481,"small","E"
7378,41,30,11,16428.4020666832,"mid","E"
7379,147,72,75,25582.8177103706,"big","E"
7380,38,19,19,143316.554874602,"mid","E"
7381,9,8,1,9219.8158746013,"small","E"
7382,101,51,50,1111.79940506254,"big","E"
7383,82,66,16,266325.871715486,"mid","E"
7384,26,22,4,35911.352766054,"mid","E"
7385,78,70,8,74566.9068061916,"mid","E"
7386,101,7,94,206926.557085311,"big","E"
7387,12,7,5,42828.7084896467,"mid","E"
7388,73,17,56,266836.918298141,"mid","E"
7389,33,19,14,11733.300845909,"mid","E"
7390,58,52,6,36840.8433027007,"mid","E"
7391,91,77,14,205237.970975071,"mid","E"
7392,130,122,8,8880.84569373549,"big","E"
7393,92,88,4,145207.928425039,"mid","E"
7394,76,17,59,46774.1309143963,"mid","E"
7395,84,27,57,24441.6146147345,"mid","E"
7396,8,8,0,8701.2142039128,"small","E"
7397,11,5,6,9935.68408746562,"mid","E"
7398,36,6,30,13505.4526429234,"mid","E"
7399,121,79,42,183177.19223702,"big","E"
7400,46,44,2,131627.22016485,"mid","E"
7401,91,53,38,300824.875211499,"mid","E"
7402,77,69,8,19971.5182153127,"mid","E"
7403,9,0,9,13696.1181689872,"small","E"
7404,123,87,36,129841.550088708,"big","E"
7405,143,90,53,114801.298323116,"big","E"
7406,99,37,62,133153.892112073,"mid","E"
7407,13,1,12,10437.0136052746,"mid","E"
7408,42,16,26,1364.09376825804,"mid","E"
7409,60,50,10,21313.7224295368,"mid","E"
7410,20,10,10,27911.3303546007,"mid","E"
7411,19,9,10,48568.9852593064,"mid","E"
7412,75,58,17,19539.1672571533,"mid","E"
7413,41,33,8,60508.8229359986,"mid","E"
7414,172,2,170,133866.985123003,"big","E"
7415,137,58,79,49478.57601717,"big","E"
7416,65,10,55,13845.9415671517,"mid","E"
7417,145,119,26,46380.2429381053,"big","E"
7418,147,118,29,96068.1753532989,"big","E"
7419,69,43,26,129935.287454615,"mid","E"
7420,47,14,33,29874.9347724484,"mid","E"
7421,55,44,11,123818.050750506,"mid","E"
7422,83,23,60,153728.903430202,"mid","E"
7423,32,24,8,18148.3957665491,"mid","E"
7424,163,97,66,215252.735814413,"big","E"
7425,150,105,45,71273.8017540612,"big","E"
7426,60,49,11,5803.43795154266,"mid","E"
7427,87,82,5,67160.7409393225,"mid","E"
7428,1,1,0,2027.80824711384,"small","E"
7429,201,170,31,528757.244501928,"big","E"
7430,122,97,25,179985.945923104,"big","E"
7431,33,25,8,29600.5799870052,"mid","E"
7432,30,17,13,22234.5497021807,"mid","E"
7433,34,16,18,13808.1834168151,"mid","E"
7434,76,56,20,37932.9317199981,"mid","E"
7435,67,48,19,93023.4882172236,"mid","E"
7436,257,107,150,225757.474207815,"big","E"
7437,2,1,1,2842.36007806891,"small","E"
7438,86,79,7,36326.6356793075,"mid","E"
7439,86,74,12,74059.2737438318,"mid","E"
7440,26,20,6,30082.8964123857,"mid","E"
7441,139,54,85,155340.782333801,"big","E"
7442,43,18,25,64571.02671759,"mid","E"
7443,135,58,77,23411.0444117151,"big","E"
7444,249,184,65,103737.61197675,"big","E"
7445,5,1,4,1298.12191279126,"small","E"
7446,17,3,14,41657.4220052872,"mid","E"
7447,34,20,14,40063.7380792575,"mid","E"
7448,6,5,1,11388.6805183183,"small","E"
7449,165,99,66,225269.898355191,"big","E"
7450,142,101,41,279375.057736438,"big","E"
7451,76,26,50,17002.2028203503,"mid","E"
7452,5,0,5,2536.74681400319,"small","E"
7453,157,41,116,213487.502001736,"big","E"
7454,27,1,26,64412.2797230114,"mid","E"
7455,80,53,27,178898.524818445,"mid","E"
7456,203,109,94,778.221196340694,"big","E"
7457,198,93,105,39957.0465207723,"big","E"
7458,79,39,40,42791.7176639052,"mid","E"
7459,181,37,144,214219.464067197,"big","E"
7460,16,5,11,3059.07831981961,"mid","E"
7461,277,246,31,13433.8567240998,"big","E"
7462,80,15,65,155635.140769613,"mid","E"
7463,167,137,30,148683.273233278,"big","E"
7464,40,38,2,46405.6610653286,"mid","E"
7465,24,18,6,63100.296739385,"mid","E"
7466,127,65,62,213515.615419828,"big","E"
7467,14,7,7,17071.2321012916,"mid","E"
7468,76,41,35,3591.89260078244,"mid","E"
7469,190,30,160,346759.510169719,"big","E"
7470,2,1,1,840.287974487464,"small","E"
7471,87,29,58,143493.927955451,"mid","E"
7472,98,78,20,89391.5393955689,"mid","E"
7473,125,32,93,329882.983504532,"big","E"
7474,62,1,61,81318.6788155948,"mid","E"
7475,48,39,9,56492.0178680785,"mid","E"
7476,10,7,3,20211.8328493947,"small","E"
7477,39,30,9,55756.5385130266,"mid","E"
7478,61,26,35,5262.22653957138,"mid","E"
7479,131,17,114,38502.9727697526,"big","E"
7480,31,13,18,32952.4940268263,"mid","E"
7481,97,45,52,63762.1815207598,"mid","E"
7482,54,25,29,25198.2095424615,"mid","E"
7483,18,10,8,6598.13374660238,"mid","E"
7484,207,202,5,347946.419148667,"big","E"
7485,144,126,18,80862.7888254783,"big","E"
7486,88,24,64,140207.737068305,"mid","E"
7487,115,52,63,120321.42026182,"big","E"
7488,75,11,64,126322.388965028,"mid","E"
7489,30,14,16,42623.9690285771,"mid","E"
7490,138,120,18,81756.9535291916,"big","E"
7491,27,26,1,3632.97750490857,"mid","E"
7492,92,19,73,67015.2672149939,"mid","E"
7493,56,20,36,44943.622879786,"mid","E"
7494,2,1,1,3478.60297795625,"small","E"
7495,63,56,7,8089.01752295743,"mid","E"
7496,30,17,13,18906.6336527099,"mid","E"
7497,121,66,55,160662.178253118,"big","E"
7498,92,32,60,117395.490475839,"mid","E"
7499,174,100,74,371844.335581369,"big","E"
7500,2,1,1,2054.79452805104,"small","E"
7501,78,21,57,99867.7330123935,"mid","E"
7502,4,2,2,2841.29223346173,"small","E"
7503,85,76,9,169027.192965965,"mid","E"
7504,36,15,21,15229.764953741,"mid","E"
7505,3,2,1,6148.58097757516,"small","E"
7506,90,85,5,69919.3718450883,"mid","E"
7507,94,32,62,44061.610412324,"mid","E"
7508,119,106,13,204924.252884279,"big","E"
7509,58,45,13,67153.9122182046,"mid","E"
7510,12,2,10,2821.13380217727,"mid","E"
7511,57,44,13,43851.8910113958,"mid","E"
7512,18,12,6,18670.4025173378,"mid","E"
7513,64,7,57,119191.650018191,"mid","E"
7514,96,84,12,21224.4359102978,"mid","E"
7515,19,5,14,38298.6705706873,"mid","E"
7516,47,7,40,17534.6191006458,"mid","E"
7517,191,58,133,75458.8180454027,"big","E"
7518,193,113,80,7331.0134468956,"big","E"
7519,7,5,2,7590.32113960236,"small","E"
7520,54,31,23,14955.2968920679,"mid","E"
7521,87,30,57,146235.859992212,"mid","E"
7522,28,25,3,35160.2146299999,"mid","E"
7523,2,2,0,2223.22070130194,"small","E"
7524,5,5,0,7616.42878929046,"small","E"
7525,140,93,47,273794.83042701,"big","E"
7526,13,11,2,13297.5529156368,"mid","E"
7527,90,27,63,135586.915863824,"mid","E"
7528,233,107,126,293518.30295972,"big","E"
7529,112,105,7,65816.550019407,"big","E"
7530,123,27,96,257628.646564907,"big","E"
7531,178,145,33,230984.903977636,"big","E"
7532,102,12,90,116258.386885302,"big","E"
7533,97,49,48,192250.789152145,"mid","E"
7534,62,52,10,85623.1065045226,"mid","E"
7535,120,24,96,138066.550250122,"big","E"
7536,213,111,102,535189.845494799,"big","E"
7537,10,1,9,8480.17500017576,"small","E"
7538,220,206,14,233318.856694296,"big","E"
7539,173,12,161,378431.894518088,"big","E"
7540,114,74,40,197093.996724862,"big","E"
7541,33,15,18,23885.1778323064,"mid","E"
7542,6,4,2,13085.7355249889,"small","E"
7543,31,24,7,19798.5510572696,"mid","E"
7544,103,5,98,35115.0334385455,"big","E"
7545,26,21,5,10389.5898091052,"mid","E"
7546,47,11,36,122020.351959075,"mid","E"
7547,43,36,7,92032.8503187876,"mid","E"
7548,112,37,75,184188.906728981,"big","E"
7549,25,10,15,21780.1447260907,"mid","E"
7550,106,39,67,20074.6453005195,"big","E"
7551,138,120,18,553156.312761,"big","E"
7552,13,8,5,19346.2572814301,"mid","E"
7553,15,6,9,1501.07913981745,"mid","E"
7554,243,147,96,89073.8116320747,"big","E"
7555,84,1,83,160873.639993852,"mid","E"
7556,114,1,113,179824.665938945,"big","E"
7557,131,9,122,311508.00754604,"big","E"
7558,177,72,105,159671.443409601,"big","E"
7559,104,76,28,153444.244148643,"big","E"
7560,145,61,84,147014.357476177,"big","E"
7561,207,163,44,295363.617498695,"big","E"
7562,108,14,94,353562.357633513,"big","E"
7563,50,7,43,30262.9510302254,"mid","E"
7564,157,42,115,190004.004147499,"big","E"
7565,142,95,47,114908.839028702,"big","E"
7566,144,21,123,40986.3372761253,"big","E"
7567,94,65,29,65507.6413409557,"mid","E"
7568,142,98,44,259159.698620085,"big","E"
7569,13,7,6,883.910210323737,"mid","E"
7570,59,30,29,65886.624636818,"mid","E"
7571,143,57,86,240848.068156291,"big","E"
7572,37,36,1,61963.3244855034,"mid","E"
7573,23,8,15,19592.777244192,"mid","E"
7574,6,3,3,10024.7852251665,"small","E"
7575,5,0,5,1441.67073754946,"small","E"
7576,68,11,57,165064.174371569,"mid","E"
7577,49,37,12,17551.5531756307,"mid","E"
7578,49,19,30,29422.0261113454,"mid","E"
7579,21,1,20,49174.7917931416,"mid","E"
7580,83,83,0,79316.8078881755,"mid","E"
7581,121,4,117,119873.539318616,"big","E"
7582,164,143,21,227793.18260194,"big","E"
7583,10,6,4,26167.2518312592,"small","E"
7584,13,4,9,1859.16132646522,"mid","E"
7585,103,24,79,24612.9692612146,"big","E"
7586,114,61,53,107424.234415006,"big","E"
7587,54,43,11,45811.5031687882,"mid","E"
7588,51,27,24,108872.825402577,"mid","E"
7589,11,4,7,12618.1536554934,"mid","E"
7590,21,6,15,17431.0157605534,"mid","E"
7591,55,39,16,135526.574557636,"mid","E"
7592,64,53,11,76627.239609458,"mid","E"
7593,55,28,27,2624.2822104025,"mid","E"
7594,67,10,57,89290.1665669683,"mid","E"
7595,65,24,41,191353.440478244,"mid","E"
7596,180,164,16,269491.431310566,"big","E"
7597,13,11,2,15286.8612180858,"mid","E"
7598,18,2,16,37322.0351448786,"mid","E"
7599,4,3,1,228.177459068694,"small","E"
7600,151,141,10,57606.1634849496,"big","E"
7601,16,16,0,28426.6378985783,"mid","E"
7602,162,123,39,127550.9506819,"big","E"
7603,6,5,1,5963.73468654471,"small","E"
7604,2,1,1,11.2145814135545,"small","E"
7605,52,16,36,37711.9923392491,"mid","E"
7606,162,73,89,191453.327989913,"big","E"
7607,119,100,19,25478.3402889346,"big","E"
7608,130,105,25,164009.163304072,"big","E"
7609,168,139,29,315561.523116892,"big","E"
7610,26,5,21,61378.6918419264,"mid","E"
7611,33,31,2,69443.0407846358,"mid","E"
7612,201,14,187,159262.93376828,"big","E"
7613,45,2,43,41929.8698304664,"mid","E"
7614,105,74,31,59789.1047916754,"big","E"
7615,36,10,26,13695.5574515492,"mid","E"
7616,133,67,66,136267.862657101,"big","E"
7617,93,80,13,74889.5937899515,"mid","E"
7618,176,104,72,585244.032004469,"big","E"
7619,22,20,2,8360.55560227648,"mid","E"
7620,59,4,55,64911.2679708999,"mid","E"
7621,265,259,6,391713.242050295,"big","E"
7622,82,52,30,125561.996043908,"mid","E"
7623,30,2,28,32456.1661970529,"mid","E"
7624,36,20,16,2776.65574484202,"mid","E"
7625,4,3,1,2970.88836724035,"small","E"
7626,47,20,27,35996.6794183314,"mid","E"
7627,27,9,18,219.49157696929,"mid","E"
7628,85,3,82,56870.9808695085,"mid","E"
7629,28,15,13,55255.5647669997,"mid","E"
7630,99,86,13,69983.3508041779,"mid","E"
7631,10,3,7,21532.7615109769,"small","E"
7632,136,107,29,52735.0096091262,"big","E"
7633,25,12,13,775.947236576354,"mid","E"
7634,7,1,6,8285.75239883865,"small","E"
7635,75,61,14,651.319034385577,"mid","E"
7636,15,14,1,20670.5544974111,"mid","E"
7637,60,11,49,119398.958222328,"mid","E"
7638,33,9,24,4476.81577347749,"mid","E"
7639,18,10,8,23372.9577354346,"mid","E"
7640,89,70,19,56749.6127836089,"mid","E"
7641,207,20,187,111002.557320038,"big","E"
7642,25,23,2,2776.18979439393,"mid","E"
7643,54,44,10,76030.4450705987,"mid","E"
7644,53,47,6,1341.32978362431,"mid","E"
7645,30,28,2,26266.5798214326,"mid","E"
7646,9,5,4,11472.103035918,"small","E"
7647,60,31,29,92444.2761901426,"mid","E"
7648,32,20,12,54607.7525396183,"mid","E"
7649,45,20,25,61753.9111527306,"mid","E"
7650,140,60,80,119926.807775116,"big","E"
7651,41,41,0,10178.7669494318,"mid","E"
7652,82,45,37,83240.2091747179,"mid","E"
7653,56,55,1,63354.9010303308,"mid","E"
7654,5,0,5,2287.45463822111,"small","E"
7655,170,89,81,213214.81433294,"big","E"
7656,25,11,14,9781.75928852923,"mid","E"
7657,97,50,47,172234.769912473,"mid","E"
7658,107,63,44,162575.825999219,"big","E"
7659,53,2,51,76262.047936845,"mid","E"
7660,72,27,45,125520.513557137,"mid","E"
7661,20,3,17,5679.93365502798,"mid","E"
7662,37,21,16,79950.0311314941,"mid","E"
7663,77,23,54,149568.438565799,"mid","E"
7664,22,16,6,21435.333925787,"mid","E"
7665,54,7,47,5288.02722555451,"mid","E"
7666,66,14,52,73572.557757287,"mid","E"
7667,23,8,15,37783.5686291748,"mid","E"
7668,58,26,32,201726.544786433,"mid","E"
7669,233,9,224,79190.9813845258,"big","E"
7670,56,56,0,60334.1926986205,"mid","E"
7671,134,54,80,326342.463001449,"big","E"
7672,90,10,80,190782.686938292,"mid","E"
7673,67,2,65,167707.059411956,"mid","E"
7674,204,130,74,174970.825171207,"big","E"
7675,119,48,71,196283.287109697,"big","E"
7676,50,20,30,39443.345548704,"mid","E"
7677,30,16,14,69244.7694147204,"mid","E"
7678,212,41,171,384938.033419054,"big","E"
7679,95,54,41,33875.9616766519,"mid","E"
7680,44,31,13,75566.7068907514,"mid","E"
7681,120,3,117,41410.9801626323,"big","E"
7682,15,9,6,33286.1345623016,"mid","E"
7683,134,57,77,234036.92563251,"big","E"
7684,16,6,10,22770.1669286982,"mid","E"
7685,172,25,147,270661.879827533,"big","E"
7686,38,21,17,28407.8518018758,"mid","E"
7687,121,117,4,239967.046869718,"big","E"
7688,61,30,31,157029.756341723,"mid","E"
7689,129,62,67,209164.479751609,"big","E"
7690,47,16,31,5783.73863816789,"mid","E"
7691,5,0,5,3972.80455464823,"small","E"
7692,127,11,116,110680.636987461,"big","E"
7693,48,35,13,66719.4876799771,"mid","E"
7694,55,11,44,125494.519736809,"mid","E"
7695,74,27,47,107550.199788932,"mid","E"
7696,4,2,2,6966.66660185271,"small","E"
7697,141,30,111,89790.2364129237,"big","E"
7698,17,14,3,24772.8743532902,"mid","E"
7699,138,42,96,114902.923586377,"big","E"
7700,173,18,155,317827.117476996,"big","E"
7701,78,69,9,90848.3003310682,"mid","E"
7702,28,10,18,21186.0054561242,"mid","E"
7703,210,28,182,96600.8790881796,"big","E"
7704,45,23,22,37054.3092414359,"mid","E"
7705,42,20,22,56481.2693141689,"mid","E"
7706,67,49,18,90789.1444404062,"mid","E"
7707,43,29,14,12059.9158983279,"mid","E"
7708,92,60,32,205308.226253644,"mid","E"
7709,115,18,97,46404.8230845339,"big","E"
7710,80,8,72,95410.5740712619,"mid","E"
7711,1,1,0,1190.65568846053,"small","E"
7712,270,117,153,108002.36883409,"big","E"
7713,53,29,24,10290.8247647203,"mid","E"
7714,32,17,15,17504.7848797798,"mid","E"
7715,30,0,30,9095.11411441364,"mid","E"
7716,107,80,27,96324.5752547481,"big","E"
7717,29,25,4,28812.8577380345,"mid","E"
7718,1,0,1,2801.93287795026,"small","E"
7719,39,21,18,11973.573340834,"mid","E"
7720,5,4,1,2286.81592653055,"small","E"
7721,4,3,1,6198.81940903594,"small","E"
7722,88,50,38,48911.0652808451,"mid","E"
7723,207,148,59,48125.9709865008,"big","E"
7724,73,57,16,55420.8094261644,"mid","E"
7725,149,68,81,288064.060763112,"big","E"
7726,82,69,13,237990.204230366,"mid","E"
7727,4,3,1,5054.09998500109,"small","E"
7728,118,66,52,70256.3978194581,"big","E"
7729,25,23,2,60262.7015711362,"mid","E"
7730,61,2,59,53688.9208278281,"mid","E"
7731,72,61,11,144546.255312051,"mid","E"
7732,94,65,29,93302.2861828807,"mid","E"
7733,1,1,0,711.37588877847,"small","E"
7734,30,28,2,26656.9977172007,"mid","E"
7735,201,75,126,116032.341394146,"big","E"
7736,14,12,2,16960.516777684,"mid","E"
7737,57,38,19,77178.2437078655,"mid","E"
7738,123,94,29,103397.952150214,"big","E"
7739,2,2,0,4057.94340197446,"small","E"
7740,46,19,27,15407.8470582828,"mid","E"
7741,116,56,60,26845.4855027038,"big","E"
7742,206,9,197,108283.871841034,"big","E"
7743,19,12,7,48138.7325997947,"mid","E"
7744,86,69,17,65937.1269939335,"mid","E"
7745,6,3,3,3891.02258495986,"small","E"
7746,50,21,29,39041.8871899765,"mid","E"
7747,80,42,38,48304.4391020667,"mid","E"
7748,59,35,24,2464.91826105255,"mid","E"
7749,75,68,7,59327.4715299954,"mid","E"
7750,51,25,26,44964.2121044672,"mid","E"
7751,60,44,16,23078.3972615305,"mid","E"
7752,168,78,90,206271.410961012,"big","E"
7753,151,97,54,35496.1696445782,"big","E"
7754,147,144,3,80549.3504286972,"big","E"
7755,11,0,11,17489.2848363119,"mid","E"
7756,106,62,44,273106.151578912,"big","E"
7757,178,164,14,299005.431502504,"big","E"
7758,12,4,8,2067.02002171784,"mid","E"
7759,40,6,34,18400.2677994492,"mid","E"
7760,52,40,12,36488.2130839912,"mid","E"
7761,18,3,15,8339.52841195279,"mid","E"
7762,62,7,55,59686.0520187923,"mid","E"
7763,129,89,40,98625.5923649512,"big","E"
7764,53,44,9,42680.0515062258,"mid","E"
7765,5,2,3,7831.19963142893,"small","E"
7766,249,136,113,353529.826938932,"big","E"
7767,51,29,22,37799.7949349374,"mid","E"
7768,21,5,16,5975.70161683685,"mid","E"
7769,130,99,31,349306.64775882,"big","E"
7770,42,35,7,103114.578838967,"mid","E"
7771,35,32,3,75790.4143034397,"mid","E"
7772,66,61,5,141171.445087586,"mid","E"
7773,155,10,145,222209.484792125,"big","E"
7774,2,1,1,661.688109672438,"small","E"
7775,112,35,77,296793.827365996,"big","E"
7776,58,49,9,165598.105520108,"mid","E"
7777,37,7,30,82491.4437515043,"mid","E"
7778,27,25,2,50113.2320324976,"mid","E"
7779,11,0,11,14423.4629101426,"mid","E"
7780,103,8,95,119652.123768141,"big","E"
7781,83,59,24,107621.246375224,"mid","E"
7782,9,4,5,24765.8728856159,"small","E"
7783,56,46,10,45463.0778115233,"mid","E"
7784,91,51,40,178790.439349861,"mid","E"
7785,67,5,62,54070.4678288757,"mid","E"
7786,34,34,0,15452.6765047878,"mid","E"
7787,114,98,16,3756.86057449653,"big","E"
7788,108,5,103,35939.8301292251,"big","E"
7789,102,92,10,133941.248838904,"big","E"
7790,98,7,91,49294.891662375,"mid","E"
7791,55,8,47,66422.5105674888,"mid","E"
7792,112,50,62,243995.721595271,"big","E"
7793,68,20,48,125511.628488779,"mid","E"
7794,203,58,145,249437.101732332,"big","E"
7795,211,157,54,386429.087502589,"big","E"
7796,77,41,36,82754.7713081368,"mid","E"
7797,140,17,123,151493.786399128,"big","E"
7798,82,40,42,91606.5004816084,"mid","E"
7799,33,32,1,12218.0228177863,"mid","E"
7800,10,1,9,1295.72668821835,"small","E"
7801,14,10,4,25518.5818077777,"mid","E"
7802,148,112,36,351484.653188788,"big","E"
7803,12,8,4,12235.8196999326,"mid","E"
7804,88,1,87,4561.3312601378,"mid","E"
7805,117,103,14,210994.033118602,"big","E"
7806,105,20,85,48382.0358164613,"big","E"
7807,123,1,122,398993.000025627,"big","E"
7808,24,7,17,19942.6035440666,"mid","E"
7809,52,49,3,41791.2980228274,"mid","E"
7810,204,202,2,522698.577789203,"big","E"
7811,4,3,1,4952.75168362255,"small","E"
7812,152,81,71,496832.379583813,"big","E"
7813,47,38,9,69405.5693849914,"mid","E"
7814,54,12,42,36667.2047435776,"mid","E"
7815,69,53,16,167579.836622078,"mid","E"
7816,42,33,9,12791.27233862,"mid","E"
7817,77,57,20,173638.086187303,"mid","E"
7818,143,92,51,373737.251351317,"big","E"
7819,54,45,9,165770.533729577,"mid","E"
7820,113,49,64,66256.3304032789,"big","E"
7821,118,12,106,136278.97957817,"big","E"
7822,35,12,23,353.121828421437,"mid","E"
7823,33,5,28,32268.2493610987,"mid","E"
7824,50,14,36,34017.6979275982,"mid","E"
7825,32,18,14,21397.7643851956,"mid","E"
7826,111,43,68,144166.115574694,"big","E"
7827,174,126,48,301115.047840227,"big","E"
7828,171,127,44,453422.481329199,"big","E"
7829,32,5,27,51130.4368603146,"mid","E"
7830,98,13,85,244544.2744436,"mid","E"
7831,11,7,4,8798.60372531669,"mid","E"
7832,1,0,1,1926.26801336021,"small","E"
7833,5,2,3,371.038224103249,"small","E"
7834,11,3,8,16682.1990978949,"mid","E"
7835,266,158,108,712317.095797062,"big","E"
7836,172,167,5,347369.76432057,"big","E"
7837,6,5,1,6839.16487445071,"small","E"
7838,112,59,53,58238.5921394274,"big","E"
7839,94,49,45,11356.7747423439,"mid","E"
7840,12,0,12,35277.8521132849,"mid","E"
7841,2,2,0,653.331210093404,"small","E"
7842,20,5,15,27261.3443625671,"mid","E"
7843,162,43,119,54570.2930864475,"big","E"
7844,63,26,37,38462.3407067926,"mid","E"
7845,88,86,2,134715.126263861,"mid","E"
7846,80,65,15,84187.5513847448,"mid","E"
7847,10,9,1,14605.4380800843,"small","E"
7848,129,109,20,321651.39307575,"big","E"
7849,126,7,119,184068.079482088,"big","E"
7850,112,10,102,184053.395217047,"big","E"
7851,126,19,107,6151.89634781167,"big","E"
7852,94,74,20,153816.739435845,"mid","E"
7853,7,1,6,9801.91013568166,"small","E"
7854,149,36,113,71778.7822007183,"big","E"
7855,24,3,21,18805.7612989794,"mid","E"
7856,61,23,38,65201.670281772,"mid","E"
7857,119,72,47,520.082321900316,"big","E"
7858,242,69,173,3333.56035516967,"big","E"
7859,139,81,58,14459.4949631185,"big","E"
7860,149,128,21,323328.599536225,"big","E"
7861,253,163,90,568891.172322882,"big","E"
7862,128,122,6,104715.022576598,"big","E"
7863,186,33,153,483285.227750789,"big","E"
7864,80,4,76,178971.427676499,"mid","E"
7865,122,66,56,95763.1843639348,"big","E"
7866,36,22,14,41103.0837909557,"mid","E"
7867,129,125,4,332610.529204833,"big","E"
7868,17,1,16,6577.35781029594,"mid","E"
7869,56,7,49,40133.7582453829,"mid","E"
7870,45,32,13,99241.823167866,"mid","E"
7871,42,40,2,31698.5548330905,"mid","E"
7872,64,0,64,84106.9724108654,"mid","E"
7873,3,1,2,5540.4137005606,"small","E"
7874,53,3,50,49972.359378836,"mid","E"
7875,132,46,86,96810.3625925803,"big","E"
7876,146,117,29,5090.92266946912,"big","E"
7877,156,7,149,319700.285228464,"big","E"
7878,83,6,77,127725.850927644,"mid","E"
7879,197,11,186,274177.426991653,"big","E"
7880,51,9,42,100660.709680243,"mid","E"
7881,68,49,19,236998.431893145,"mid","E"
7882,151,93,58,543151.576021109,"big","E"
7883,293,210,83,475423.873407831,"big","E"
7884,311,49,262,654817.862063213,"big","E"
7885,202,34,168,78100.7057777845,"big","E"
7886,288,86,202,767591.447232016,"big","E"
7887,132,48,84,201238.601604499,"big","E"
7888,228,146,82,331240.392293393,"big","E"
7889,124,121,3,7311.74737909815,"big","E"
7890,32,15,17,53220.1364494073,"mid","E"
7891,12,10,2,24.4439631920691,"mid","E"
7892,84,43,41,19538.2381156804,"mid","E"
7893,36,36,0,43248.7094716154,"mid","E"
7894,23,5,18,68175.2023551732,"mid","E"
7895,108,48,60,378727.518523142,"big","E"
7896,15,9,6,1132.77871794022,"mid","E"
7897,65,24,41,64759.095855886,"mid","E"
7898,187,32,155,234342.044781404,"big","E"
7899,23,8,15,13935.1375824492,"mid","E"
7900,38,30,8,47987.0464176274,"mid","E"
7901,39,13,26,86092.3961787019,"mid","E"
7902,71,54,17,7581.81831813034,"mid","E"
7903,112,105,7,73660.943216074,"big","E"
7904,86,14,72,67428.1091058624,"mid","E"
7905,54,37,17,60811.1236116226,"mid","E"
7906,12,4,8,11722.9173278457,"mid","E"
7907,131,120,11,109266.944763199,"big","E"
7908,22,17,5,6529.73596259989,"mid","E"
7909,171,53,118,292761.223794065,"big","E"
7910,162,35,127,9391.56902705207,"big","E"
7911,101,92,9,83436.0906924126,"big","E"
7912,91,69,22,115734.656566704,"mid","E"
7913,3,0,3,5231.24989365427,"small","E"
7914,153,44,109,189071.496732357,"big","E"
7915,95,70,25,100791.039254465,"mid","E"
7916,176,130,46,555547.314082798,"big","E"
7917,153,103,50,94824.1544729858,"big","E"
7918,262,98,164,528759.568222862,"big","E"
7919,131,127,4,121287.270990563,"big","E"
7920,9,4,5,3862.07448550741,"small","E"
7921,40,4,36,67795.2547551977,"mid","E"
7922,49,34,15,13191.49111778,"mid","E"
7923,67,53,14,107877.861576259,"mid","E"
7924,64,19,45,15602.8314932128,"mid","E"
7925,127,40,87,216103.745197567,"big","E"
7926,91,6,85,100137.780763677,"mid","E"
7927,117,75,42,208893.38397048,"big","E"
7928,8,0,8,10995.8948278512,"small","E"
7929,58,18,40,25820.4685218572,"mid","E"
7930,69,21,48,88141.2195231142,"mid","E"
7931,46,33,13,14940.9869825657,"mid","E"
7932,14,7,7,15170.3756853406,"mid","E"
7933,148,114,34,143133.084568633,"big","E"
7934,112,86,26,81603.1410134151,"big","E"
7935,24,11,13,42275.1641174354,"mid","E"
7936,124,96,28,74085.695265445,"big","E"
7937,74,51,23,3774.33254487246,"mid","E"
7938,85,74,11,126925.517006487,"mid","E"
7939,190,89,101,37702.2753986198,"big","E"
7940,56,27,29,83731.985073517,"mid","E"
7941,84,33,51,78871.5147635757,"mid","E"
7942,142,112,30,100703.735775984,"big","E"
7943,94,79,15,108076.735759944,"mid","E"
7944,107,79,28,60353.2706253624,"big","E"
7945,106,3,103,142648.368009929,"big","E"
7946,21,6,15,13440.7648074582,"mid","E"
7947,169,100,69,356277.21010516,"big","E"
7948,8,0,8,12800.3256997875,"small","E"
7949,107,30,77,260072.470712842,"big","E"
7950,30,18,12,10398.3627644841,"mid","E"
7951,36,1,35,24897.6117167251,"mid","E"
7952,27,20,7,29783.8059630487,"mid","E"
7953,62,39,23,146371.474173976,"mid","E"
7954,119,1,118,218063.015020042,"big","E"
7955,195,87,108,463679.135975934,"big","E"
7956,168,63,105,3426.33084664299,"big","E"
7957,24,9,15,34073.470618257,"mid","E"
7958,68,32,36,20159.3686735531,"mid","E"
7959,30,21,9,49173.8701946219,"mid","E"
7960,219,107,112,513757.320313295,"big","E"
7961,67,32,35,119892.806906946,"mid","E"
7962,55,11,44,21186.4360193437,"mid","E"
7963,12,3,9,21521.9174054566,"mid","E"
7964,196,116,80,442276.320851097,"big","E"
7965,22,8,14,55549.5334165726,"mid","E"
7966,3,2,1,3236.23892604706,"small","E"
7967,2,1,1,3564.88234062607,"small","E"
7968,72,2,70,144733.492238161,"mid","E"
7969,19,11,8,7546.07118012538,"mid","E"
7970,4,3,1,4529.34227004047,"small","E"
7971,169,24,145,364280.975197077,"big","E"
7972,5,0,5,6899.04841598224,"small","E"
7973,36,9,27,93128.2800889002,"mid","E"
7974,78,30,48,48487.5524998187,"mid","E"
7975,49,31,18,71517.5843484136,"mid","E"
7976,33,3,30,44445.728510515,"mid","E"
7977,219,111,108,559835.41488825,"big","E"
7978,157,116,41,475.771889290308,"big","E"
7979,7,1,6,6394.4482196972,"small","E"
7980,63,49,14,50183.5246369723,"mid","E"
7981,24,11,13,31930.4299593047,"mid","E"
7982,79,73,6,116687.717352623,"mid","E"
7983,99,49,50,32102.755971555,"mid","E"
7984,50,5,45,18161.6586525321,"mid","E"
7985,31,21,10,41632.0852896515,"mid","E"
7986,90,74,16,23186.8549190992,"mid","E"
7987,160,45,115,90247.0040941352,"big","E"
7988,127,4,123,36079.8147458034,"big","E"
7989,163,39,124,407204.114494474,"big","E"
7990,95,79,16,84623.5531901081,"mid","E"
7991,147,90,57,295078.10181453,"big","E"
7992,178,175,3,199201.806705321,"big","E"
7993,24,20,4,40353.0653548303,"mid","E"
7994,16,5,11,25634.922479796,"mid","E"
7995,10,4,6,7918.17978040798,"small","E"
7996,2,1,1,4706.95782502528,"small","E"
7997,52,32,20,45602.6159531539,"mid","E"
7998,78,34,44,71.2465052472787,"mid","E"
7999,42,23,19,24046.5132035195,"mid","E"
8000,48,16,32,141774.980300428,"mid","E"
8001,113,27,86,28531.3551540072,"big","F"
8002,118,74,44,13839.7337194369,"big","F"
8003,75,25,50,38904.9855416578,"mid","F"
8004,51,31,20,63502.4656194781,"mid","F"
8005,92,46,46,95456.9636215167,"mid","F"
8006,96,89,7,171297.26136526,"mid","F"
8007,1,0,1,570.180211079258,"small","F"
8008,16,2,14,5537.12411232951,"mid","F"
8009,34,2,32,39477.536516198,"mid","F"
8010,26,2,24,36359.8536599108,"mid","F"
8011,125,42,83,331799.623463564,"big","F"
8012,204,45,159,383633.404276374,"big","F"
8013,88,77,11,108975.007441033,"mid","F"
8014,60,57,3,81367.8689027177,"mid","F"
8015,16,8,8,2244.10291198906,"mid","F"
8016,35,6,29,62352.517305242,"mid","F"
8017,103,48,55,35097.2433681524,"big","F"
8018,348,220,128,461056.643825143,"big","F"
8019,43,1,42,50928.8064649801,"mid","F"
8020,52,4,48,128898.848628931,"mid","F"
8021,99,17,82,260668.349366165,"mid","F"
8022,65,31,34,225314.56963509,"mid","F"
8023,78,42,36,50384.719633296,"mid","F"
8024,281,137,144,207299.643205446,"big","F"
8025,70,61,9,76326.6639098583,"mid","F"
8026,51,33,18,58011.0836266542,"mid","F"
8027,240,49,191,620034.648700551,"big","F"
8028,32,17,15,40664.9790080254,"mid","F"
8029,31,4,27,18230.5585643495,"mid","F"
8030,31,18,13,27455.7233759557,"mid","F"
8031,186,7,179,240780.872356119,"big","F"
8032,109,41,68,135881.673745307,"big","F"
8033,12,11,1,17717.5598458306,"mid","F"
8034,46,15,31,62725.4851781422,"mid","F"
8035,111,89,22,159008.696255769,"big","F"
8036,90,17,73,61528.6010469517,"mid","F"
8037,139,6,133,4.78310995501749,"big","F"
8038,17,6,11,18284.8383483095,"mid","F"
8039,96,39,57,89797.8910421017,"mid","F"
8040,71,56,15,18951.3228445971,"mid","F"
8041,44,17,27,93206.2506818246,"mid","F"
8042,127,16,111,70922.2438549998,"big","F"
8043,29,16,13,35713.6410411369,"mid","F"
8044,56,11,45,156786.045806735,"mid","F"
8045,40,33,7,10394.1035457592,"mid","F"
8046,80,23,57,143248.505971067,"mid","F"
8047,121,8,113,15430.8818238971,"big","F"
8048,27,27,0,67726.459288984,"mid","F"
8049,110,82,28,135318.046424524,"big","F"
8050,49,28,21,28916.2717344273,"mid","F"
8051,41,4,37,53872.699164775,"mid","F"
8052,128,110,18,30422.8302876376,"big","F"
8053,58,48,10,5856.86997937907,"mid","F"
8054,268,141,127,278442.129017594,"big","F"
8055,172,151,21,148440.91439118,"big","F"
8056,80,52,28,84802.2452908709,"mid","F"
8057,16,1,15,20496.4916617357,"mid","F"
8058,27,10,17,1248.558840134,"mid","F"
8059,53,44,9,83360.4813116091,"mid","F"
8060,175,48,127,75102.3128623243,"big","F"
8061,23,18,5,24276.6024162752,"mid","F"
8062,11,10,1,27508.6767813515,"mid","F"
8063,33,27,6,19685.4606277946,"mid","F"
8064,131,29,102,116727.268984055,"big","F"
8065,173,103,70,97918.8027614592,"big","F"
8066,2,2,0,448.342870074123,"small","F"
8067,65,61,4,61738.1675447878,"mid","F"
8068,243,139,104,264965.818805834,"big","F"
8069,30,20,10,1741.50046981238,"mid","F"
8070,22,17,5,14907.8000632383,"mid","F"
8071,20,10,10,62586.9788276929,"mid","F"
8072,94,73,21,99729.2921518311,"mid","F"
8073,47,32,15,82403.1081160222,"mid","F"
8074,144,38,106,162022.635079912,"big","F"
8075,88,23,65,200367.277316014,"mid","F"
8076,87,45,42,182964.042444551,"mid","F"
8077,128,65,63,188981.843865622,"big","F"
8078,55,43,12,122598.986053538,"mid","F"
8079,275,26,249,32919.269095332,"big","F"
8080,112,87,25,196982.793298211,"big","F"
8081,39,4,35,29346.7113360168,"mid","F"
8082,25,14,11,17740.1494653801,"mid","F"
8083,56,1,55,44120.1324291667,"mid","F"
8084,27,26,1,14340.1570684911,"mid","F"
8085,73,17,56,36174.10221395,"mid","F"
8086,65,53,12,98036.1640330904,"mid","F"
8087,2,1,1,4000.19405307028,"small","F"
8088,44,21,23,63719.9972389141,"mid","F"
8089,92,66,26,55671.4414136313,"mid","F"
8090,23,3,20,19531.1250113484,"mid","F"
8091,13,6,7,31081.8131907566,"mid","F"
8092,54,13,41,32645.8575299788,"mid","F"
8093,71,35,36,36574.6944153452,"mid","F"
8094,84,21,63,52830.2964626053,"mid","F"
8095,187,77,110,137028.870325937,"big","F"
8096,37,19,18,7475.0977769707,"mid","F"
8097,111,8,103,53752.0401305501,"big","F"
8098,4,3,1,3601.30848508445,"small","F"
8099,38,4,34,15852.2836041725,"mid","F"
8100,182,35,147,99415.0205644268,"big","F"
8101,91,50,41,44340.3693253019,"mid","F"
8102,95,13,82,15561.6155149545,"mid","F"
8103,150,48,102,265639.56371441,"big","F"
8104,91,82,9,215858.439747223,"mid","F"
8105,27,24,3,18327.2919923817,"mid","F"
8106,45,4,41,14948.0542434158,"mid","F"
8107,47,22,25,28965.349607469,"mid","F"
8108,10,7,3,24038.7686846962,"small","F"
8109,111,108,3,312706.440586732,"big","F"
8110,6,1,5,693.327203562524,"small","F"
8111,193,46,147,108942.024876985,"big","F"
8112,200,33,167,72950.8708474018,"big","F"
8113,12,9,3,12010.3370894415,"mid","F"
8114,140,81,59,248562.323336627,"big","F"
8115,26,2,24,29236.1668880459,"mid","F"
8116,32,7,25,7379.58267611232,"mid","F"
8117,38,18,20,3279.11380988433,"mid","F"
8118,16,12,4,28233.0445168318,"mid","F"
8119,157,154,3,278357.990165309,"big","F"
8120,152,125,27,32687.663381296,"big","F"
8121,44,3,41,26372.5934063062,"mid","F"
8122,3,3,0,1313.82184753091,"small","F"
8123,20,19,1,4373.53784959168,"mid","F"
8124,55,35,20,44496.8188160823,"mid","F"
8125,133,86,47,188486.663546753,"big","F"
8126,124,56,68,31012.3390395689,"big","F"
8127,139,50,89,245519.903449059,"big","F"
8128,194,156,38,324463.481344548,"big","F"
8129,77,74,3,47518.1718931409,"mid","F"
8130,148,4,144,371369.426488405,"big","F"
8131,83,8,75,174079.799007253,"mid","F"
8132,79,57,22,166370.836106546,"mid","F"
8133,102,34,68,102156.347072352,"big","F"
8134,2,1,1,3901.83443214861,"small","F"
8135,43,31,12,14528.9729762516,"mid","F"
8136,34,30,4,73117.8511129796,"mid","F"
8137,3,2,1,20.9944218656185,"small","F"
8138,99,67,32,26847.6589745106,"mid","F"
8139,82,58,24,33296.0440648905,"mid","F"
8140,5,1,4,5630.87915214143,"small","F"
8141,112,2,110,142614.407112317,"big","F"
8142,16,5,11,29883.7637719986,"mid","F"
8143,31,27,4,75193.235467535,"mid","F"
8144,233,66,167,95161.957704039,"big","F"
8145,24,9,15,37191.2995134675,"mid","F"
8146,71,63,8,224166.037119305,"mid","F"
8147,38,32,6,13417.782782349,"mid","F"
8148,81,34,47,16343.5426799593,"mid","F"
8149,84,30,54,158797.955001139,"mid","F"
8150,56,12,44,70464.9500638129,"mid","F"
8151,42,42,0,787.027105023996,"mid","F"
8152,46,16,30,55323.5437258799,"mid","F"
8153,15,0,15,25020.3915553691,"mid","F"
8154,59,3,56,85989.1627485436,"mid","F"
8155,24,16,8,22423.3301491374,"mid","F"
8156,60,28,32,85727.5066041021,"mid","F"
8157,190,132,58,59910.1597046346,"big","F"
8158,43,16,27,2805.83383609838,"mid","F"
8159,37,1,36,9870.36698331568,"mid","F"
8160,73,18,55,50063.810377206,"mid","F"
8161,124,67,57,76029.2471730986,"big","F"
8162,50,28,22,67100.3690222744,"mid","F"
8163,92,70,22,33250.7111279795,"mid","F"
8164,103,94,9,50118.2147533602,"big","F"
8165,131,70,61,207119.961166963,"big","F"
8166,29,20,9,48869.4956241511,"mid","F"
8167,13,4,9,11801.7029618139,"mid","F"
8168,145,132,13,319596.188351631,"big","F"
8169,26,22,4,44048.1472974348,"mid","F"
8170,83,10,73,6395.70326087185,"mid","F"
8171,38,14,24,310.664507577085,"mid","F"
8172,77,73,4,8511.69144893173,"mid","F"
8173,12,11,1,36437.7337660602,"mid","F"
8174,83,23,60,24190.0504404287,"mid","F"
8175,54,37,17,43166.7935280625,"mid","F"
8176,3,1,2,5581.87732988496,"small","F"
8177,191,174,17,333315.779746753,"big","F"
8178,33,28,5,68017.1609885198,"mid","F"
8179,64,20,44,124744.665126553,"mid","F"
8180,76,5,71,110310.005383343,"mid","F"
8181,8,7,1,287.920438503234,"small","F"
8182,53,52,1,36298.7794361743,"mid","F"
8183,233,146,87,101543.756405441,"big","F"
8184,88,68,20,11050.5138941884,"mid","F"
8185,28,0,28,12939.5772730707,"mid","F"
8186,301,25,276,24345.6358515987,"big","F"
8187,57,23,34,24983.1024443059,"mid","F"
8188,10,1,9,8461.40844215694,"small","F"
8189,50,12,38,83565.9398489138,"mid","F"
8190,21,14,7,37138.0047460498,"mid","F"
8191,184,147,37,79530.3339974609,"big","F"
8192,67,38,29,80357.4978303436,"mid","F"
8193,75,21,54,77162.145167643,"mid","F"
8194,19,6,13,14835.7034889016,"mid","F"
8195,128,49,79,106812.338103632,"big","F"
8196,16,15,1,22803.6764884123,"mid","F"
8197,88,33,55,89961.735815742,"mid","F"
8198,3,1,2,5442.58283584935,"small","F"
8199,68,65,3,2538.83493174405,"mid","F"
8200,46,34,12,45171.6737674102,"mid","F"
8201,84,7,77,71892.900087321,"mid","F"
8202,105,38,67,127485.394736191,"big","F"
8203,61,6,55,88435.3132238735,"mid","F"
8204,49,7,42,65857.9515172308,"mid","F"
8205,101,10,91,127987.086213265,"big","F"
8206,24,6,18,3214.84009975152,"mid","F"
8207,96,62,34,193770.921128608,"mid","F"
8208,23,10,13,16061.7583641538,"mid","F"
8209,14,1,13,9579.97162408452,"mid","F"
8210,15,15,0,10397.400756005,"mid","F"
8211,62,47,15,88300.2138804832,"mid","F"
8212,50,25,25,41848.8011118147,"mid","F"
8213,49,42,7,105187.672020978,"mid","F"
8214,217,47,170,326447.044450443,"big","F"
8215,145,113,32,325112.971785359,"big","F"
8216,6,2,4,8413.51206161401,"small","F"
8217,16,10,6,4376.06771902444,"mid","F"
8218,23,17,6,42172.3062676699,"mid","F"
8219,31,12,19,27711.4105575284,"mid","F"
8220,66,58,8,9159.50364296079,"mid","F"
8221,30,10,20,44838.0740570116,"mid","F"
8222,72,53,19,72811.9964441805,"mid","F"
8223,292,23,269,87103.1149390685,"big","F"
8224,89,30,59,38250.8117778612,"mid","F"
8225,58,26,32,100211.61915257,"mid","F"
8226,48,13,35,6919.67358430816,"mid","F"
8227,62,32,30,97371.3245442882,"mid","F"
8228,1,0,1,76.8324930066808,"small","F"
8229,162,14,148,264386.446203677,"big","F"
8230,103,18,85,136069.323202968,"big","F"
8231,60,10,50,22393.7207494443,"mid","F"
8232,219,149,70,388526.314852679,"big","F"
8233,70,46,24,6116.14772591018,"mid","F"
8234,166,21,145,35248.208384329,"big","F"
8235,95,18,77,204448.799199005,"mid","F"
8236,49,40,9,5369.4980068548,"mid","F"
8237,118,97,21,192192.163131212,"big","F"
8238,106,1,105,19750.6099265153,"big","F"
8239,11,1,10,23699.5362600743,"mid","F"
8240,61,55,6,47129.3834296162,"mid","F"
8241,43,8,35,64277.8093738215,"mid","F"
8242,46,43,3,60525.0286866196,"mid","F"
8243,38,14,24,37636.4564245207,"mid","F"
8244,158,62,96,91586.0294590038,"big","F"
8245,219,113,106,160979.970408917,"big","F"
8246,57,27,30,13149.1155151416,"mid","F"
8247,100,25,75,46613.7411507361,"mid","F"
8248,51,9,42,79137.5023188661,"mid","F"
8249,51,35,16,65979.5288761566,"mid","F"
8250,33,7,26,63615.1108275679,"mid","F"
8251,43,23,20,82689.05765243,"mid","F"
8252,83,16,67,182364.198039745,"mid","F"
8253,28,3,25,36711.4435455236,"mid","F"
8254,139,100,39,33957.8949136935,"big","F"
8255,72,25,47,54445.8163556879,"mid","F"
8256,22,20,2,23534.1207655142,"mid","F"
8257,23,7,16,38344.320253785,"mid","F"
8258,95,91,4,28279.7770369103,"mid","F"
8259,50,15,35,60385.812725662,"mid","F"
8260,4,2,2,2099.58035087246,"small","F"
8261,47,43,4,23557.7142914547,"mid","F"
8262,38,24,14,63327.6635926243,"mid","F"
8263,195,99,96,279296.512021502,"big","F"
8264,26,13,13,23209.6529548128,"mid","F"
8265,4,4,0,3160.27297191551,"small","F"
8266,31,14,17,36442.6396866839,"mid","F"
8267,121,37,84,157883.940999519,"big","F"
8268,74,60,14,137958.121171556,"mid","F"
8269,102,56,46,107685.496057838,"big","F"
8270,89,64,25,56418.8460523892,"mid","F"
8271,244,115,129,73980.6131648633,"big","F"
8272,65,0,65,24370.4861759132,"mid","F"
8273,231,158,73,72351.4316272464,"big","F"
8274,71,12,59,28965.7951087885,"mid","F"
8275,225,90,135,546420.580556879,"big","F"
8276,107,51,56,30427.5734976065,"big","F"
8277,44,20,24,102635.757899454,"mid","F"
8278,187,29,158,225894.743036651,"big","F"
8279,48,25,23,32019.1113317322,"mid","F"
8280,70,22,48,62975.4684890453,"mid","F"
8281,110,21,89,7724.99952366817,"big","F"
8282,79,43,36,72573.7076982958,"mid","F"
8283,90,35,55,94780.8497023633,"mid","F"
8284,126,12,114,94514.799011292,"big","F"
8285,172,47,125,290494.089492271,"big","F"
8286,68,35,33,155648.354687126,"mid","F"
8287,35,19,16,29875.8979086683,"mid","F"
8288,73,48,25,112232.524772878,"mid","F"
8289,115,6,109,110422.288253232,"big","F"
8290,85,43,42,32898.4528282802,"mid","F"
8291,109,56,53,175866.448080828,"big","F"
8292,221,207,14,326097.186412645,"big","F"
8293,69,52,17,36597.0373301068,"mid","F"
8294,4,2,2,3176.28354392124,"small","F"
8295,53,31,22,88835.3784139049,"mid","F"
8296,150,0,150,51900.0267634943,"big","F"
8297,16,12,4,25378.8428099803,"mid","F"
8298,71,68,3,25884.3417724068,"mid","F"
8299,7,4,3,9289.70825859816,"small","F"
8300,136,64,72,4374.54138822873,"big","F"
8301,7,7,0,13365.161734296,"small","F"
8302,37,18,19,4351.09769297006,"mid","F"
8303,118,63,55,349193.121580658,"big","F"
8304,33,0,33,108338.597687479,"mid","F"
8305,107,8,99,57524.3864104163,"big","F"
8306,98,10,88,383092.537011609,"mid","F"
8307,141,1,140,242462.277452731,"big","F"
8308,48,12,36,21487.1629604106,"mid","F"
8309,65,25,40,83227.4724992179,"mid","F"
8310,85,70,15,69834.099113663,"mid","F"
8311,31,15,16,69108.1609119749,"mid","F"
8312,71,28,43,69198.7246601459,"mid","F"
8313,20,7,13,3304.35990578691,"mid","F"
8314,13,2,11,10654.6463895868,"mid","F"
8315,40,11,29,43317.8588769597,"mid","F"
8316,88,2,86,142849.578985077,"mid","F"
8317,86,22,64,61316.7888860003,"mid","F"
8318,183,8,175,352784.555244579,"big","F"
8319,78,31,47,51380.9103637452,"mid","F"
8320,44,10,34,38288.0907306205,"mid","F"
8321,15,12,3,27758.7448195798,"mid","F"
8322,61,37,24,57086.4472525673,"mid","F"
8323,28,24,4,2341.31190957647,"mid","F"
8324,49,2,47,27128.0207184042,"mid","F"
8325,40,39,1,102766.133356211,"mid","F"
8326,88,82,6,34888.2181271891,"mid","F"
8327,42,32,10,109935.385787608,"mid","F"
8328,35,1,34,23274.1919279936,"mid","F"
8329,153,97,56,234611.997906789,"big","F"
8330,43,33,10,125920.529756718,"mid","F"
8331,80,45,35,29505.6170588735,"mid","F"
8332,154,46,108,4072.74761540194,"big","F"
8333,50,8,42,35121.8823609083,"mid","F"
8334,25,11,14,38861.5974681998,"mid","F"
8335,20,4,16,25800.5347609038,"mid","F"
8336,128,110,18,124035.615762006,"big","F"
8337,112,21,91,158825.39025546,"big","F"
8338,44,13,31,75139.0949758347,"mid","F"
8339,66,1,65,106101.749731901,"mid","F"
8340,46,44,2,39406.0911415005,"mid","F"
8341,19,13,6,20560.6183204288,"mid","F"
8342,65,24,41,73633.6444245547,"mid","F"
8343,120,39,81,22011.4864652217,"big","F"
8344,183,59,124,244538.014020919,"big","F"
8345,61,16,45,26579.7032543343,"mid","F"
8346,121,57,64,140268.979974257,"big","F"
8347,39,24,15,27846.4648502245,"mid","F"
8348,29,4,25,7027.65801423593,"mid","F"
8349,21,17,4,3882.05152202758,"mid","F"
8350,10,10,0,4812.8743445075,"small","F"
8351,113,47,66,129728.455663118,"big","F"
8352,32,18,14,25156.7973469823,"mid","F"
8353,71,39,32,91582.3764193,"mid","F"
8354,126,51,75,131476.528369188,"big","F"
8355,107,65,42,215127.979306663,"big","F"
8356,33,23,10,67858.6932356893,"mid","F"
8357,83,68,15,53925.6152042545,"mid","F"
8358,136,118,18,17203.9819748489,"big","F"
8359,45,21,24,118910.324159342,"mid","F"
8360,109,14,95,203949.743290428,"big","F"
8361,28,15,13,42298.3431304255,"mid","F"
8362,173,105,68,133262.128358606,"big","F"
8363,92,90,2,144912.634076201,"mid","F"
8364,38,28,10,10940.3462836136,"mid","F"
8365,17,8,9,11536.5394463138,"mid","F"
8366,3,0,3,216.040312104371,"small","F"
8367,44,41,3,28922.4756099959,"mid","F"
8368,52,40,12,74701.6675453944,"mid","F"
8369,25,18,7,30059.2201025419,"mid","F"
8370,199,0,199,225748.413339385,"big","F"
8371,42,41,1,38780.6399237023,"mid","F"
8372,173,131,42,144942.903016212,"big","F"
8373,167,111,56,225052.529628256,"big","F"
8374,47,33,14,101053.797739719,"mid","F"
8375,37,20,17,6674.38498845904,"mid","F"
8376,37,30,7,102327.053086481,"mid","F"
8377,146,61,85,72962.9962774194,"big","F"
8378,34,28,6,58473.5401666399,"mid","F"
8379,32,5,27,24400.4882851328,"mid","F"
8380,90,46,44,109857.906836067,"mid","F"
8381,96,42,54,56346.2690068267,"mid","F"
8382,64,26,38,68601.6497397359,"mid","F"
8383,31,22,9,1022.84195226115,"mid","F"
8384,99,53,46,96606.8892555374,"mid","F"
8385,1,0,1,3136.21686931896,"small","F"
8386,175,165,10,301094.980771451,"big","F"
8387,37,11,26,39341.5466948308,"mid","F"
8388,85,72,13,239383.94582252,"mid","F"
8389,60,24,36,1586.65063880405,"mid","F"
8390,9,4,5,9120.26419170635,"small","F"
8391,130,76,54,202459.70512846,"big","F"
8392,92,26,66,30122.1658744172,"mid","F"
8393,104,20,84,171073.410458852,"big","F"
8394,78,19,59,222240.097694725,"mid","F"
8395,25,6,19,44270.8989709823,"mid","F"
8396,60,16,44,28081.113553696,"mid","F"
8397,1,1,0,1742.79910300076,"small","F"
8398,154,118,36,21237.9901752102,"big","F"
8399,9,2,7,1750.52684099792,"small","F"
8400,137,94,43,98441.4297645209,"big","F"
8401,172,46,126,255879.455959366,"big","F"
8402,208,130,78,426023.640839526,"big","F"
8403,207,180,27,121623.274270608,"big","F"
8404,61,28,33,61729.2481596299,"mid","F"
8405,134,92,42,171833.326009891,"big","F"
8406,68,60,8,33553.9120212988,"mid","F"
8407,28,8,20,47116.1594826561,"mid","F"
8408,46,2,44,48789.444636494,"mid","F"
8409,102,71,31,120519.031245698,"big","F"
8410,93,66,27,110582.270709235,"mid","F"
8411,57,13,44,107590.57611913,"mid","F"
8412,90,15,75,36074.9522954811,"mid","F"
8413,100,63,37,25603.5937836292,"mid","F"
8414,14,0,14,10009.9789943738,"mid","F"
8415,106,20,86,67665.0014448238,"big","F"
8416,63,43,20,141712.777852644,"mid","F"
8417,41,8,33,9053.09536976227,"mid","F"
8418,52,36,16,72648.4599128803,"mid","F"
8419,90,63,27,103758.148096959,"mid","F"
8420,178,41,137,123508.734573592,"big","F"
8421,3,1,2,3589.15955271707,"small","F"
8422,92,82,10,66668.9664566308,"mid","F"
8423,43,33,10,41234.6562253901,"mid","F"
8424,45,22,23,25275.4821376874,"mid","F"
8425,114,44,70,214089.998260309,"big","F"
8426,104,25,79,80409.7083971119,"big","F"
8427,136,0,136,39136.237755278,"big","F"
8428,212,36,176,210013.942676118,"big","F"
8429,103,18,85,209665.482978424,"big","F"
8430,101,3,98,203213.457401333,"big","F"
8431,6,0,6,5549.63063202355,"small","F"
8432,41,8,33,1340.04632340497,"mid","F"
8433,76,2,74,78519.8092346465,"mid","F"
8434,68,29,39,109512.649605023,"mid","F"
8435,123,80,43,85529.380713194,"big","F"
8436,106,57,49,14921.2013738231,"big","F"
8437,24,22,2,28374.6326170847,"mid","F"
8438,167,120,47,86991.636843246,"big","F"
8439,109,66,43,154359.340193277,"big","F"
8440,81,51,30,264319.422715047,"mid","F"
8441,232,50,182,345856.656926175,"big","F"
8442,60,47,13,17282.5623170629,"mid","F"
8443,62,19,43,76970.3895209243,"mid","F"
8444,145,99,46,85378.7644091393,"big","F"
8445,16,3,13,15453.2560341381,"mid","F"
8446,35,32,3,34320.8833573247,"mid","F"
8447,66,62,4,41167.558848033,"mid","F"
8448,131,38,93,192253.888978986,"big","F"
8449,67,28,39,107129.48639993,"mid","F"
8450,42,23,19,165273.676029427,"mid","F"
8451,84,12,72,29649.4670976045,"mid","F"
8452,175,126,49,76276.6604911483,"big","F"
8453,45,12,33,2088.82571657923,"mid","F"
8454,273,4,269,327817.624885528,"big","F"
8455,83,29,54,39482.5878563542,"mid","F"
8456,93,31,62,55422.0863827287,"mid","F"
8457,93,36,57,54349.9916399013,"mid","F"
8458,120,115,5,268350.969209815,"big","F"
8459,139,108,31,56207.0216786584,"big","F"
8460,20,7,13,21646.910431093,"mid","F"
8461,22,21,1,43346.1428978399,"mid","F"
8462,105,38,67,136526.362939646,"big","F"
8463,154,107,47,72344.1521550211,"big","F"
8464,18,1,17,27153.1893632887,"mid","F"
8465,53,49,4,19605.905501254,"mid","F"
8466,171,49,122,190108.58625546,"big","F"
8467,2,1,1,2672.10937707649,"small","F"
8468,86,36,50,129533.985146253,"mid","F"
8469,37,21,16,54861.1655143272,"mid","F"
8470,102,4,98,246900.912412318,"big","F"
8471,54,40,14,60849.2737903869,"mid","F"
8472,48,1,47,56069.1698102639,"mid","F"
8473,82,26,56,179941.560164109,"mid","F"
8474,42,32,10,75114.2623759433,"mid","F"
8475,124,73,51,206248.541417687,"big","F"
8476,95,41,54,56782.5163881005,"mid","F"
8477,70,10,60,149868.387520999,"mid","F"
8478,79,9,70,75364.5001818107,"mid","F"
8479,83,56,27,11996.2833813188,"mid","F"
8480,42,40,2,99342.7886256358,"mid","F"
8481,66,35,31,5547.38257638483,"mid","F"
8482,31,28,3,50695.7495805227,"mid","F"
8483,110,108,2,149051.01546121,"big","F"
8484,28,4,24,774.861646857928,"mid","F"
8485,118,58,60,104062.745388307,"big","F"
8486,212,148,64,263465.289922024,"big","F"
8487,27,23,4,41764.07517362,"mid","F"
8488,98,77,21,216270.222111965,"mid","F"
8489,77,68,9,135653.022815882,"mid","F"
8490,4,2,2,1094.31775385024,"small","F"
8491,36,32,4,32210.9088574493,"mid","F"
8492,29,7,22,65092.0242011393,"mid","F"
8493,151,150,1,8291.65578586277,"big","F"
8494,151,23,128,173200.75763539,"big","F"
8495,86,32,54,118127.644910812,"mid","F"
8496,37,17,20,31860.7044792375,"mid","F"
8497,41,13,28,62761.1860451671,"mid","F"
8498,74,13,61,41747.9592703932,"mid","F"
8499,18,10,8,8656.99720135182,"mid","F"
8500,39,11,28,14221.5399937123,"mid","F"
8501,140,70,70,367844.774383215,"big","F"
8502,147,59,88,7787.49511205427,"big","F"
8503,12,11,1,23189.7873765159,"mid","F"
8504,6,1,5,2033.82932581386,"small","F"
8505,119,45,74,51717.5485871074,"big","F"
8506,96,88,8,296366.484815566,"mid","F"
8507,198,60,138,156030.440718741,"big","F"
8508,81,51,30,193849.473202785,"mid","F"
8509,143,99,44,327337.252799607,"big","F"
8510,137,15,122,196948.490238245,"big","F"
8511,20,19,1,30810.961020393,"mid","F"
8512,56,53,3,94781.9717347423,"mid","F"
8513,80,3,77,186614.856755697,"mid","F"
8514,58,25,33,24643.5790145277,"mid","F"
8515,100,36,64,76194.0375039966,"mid","F"
8516,62,33,29,31037.6602521005,"mid","F"
8517,55,2,53,10826.197336445,"mid","F"
8518,210,12,198,591442.668384307,"big","F"
8519,4,3,1,47.7990942838869,"small","F"
8520,252,67,185,429586.279312645,"big","F"
8521,182,124,58,66546.0388123837,"big","F"
8522,166,59,107,489793.330379582,"big","F"
8523,17,12,5,25860.4917921576,"mid","F"
8524,56,22,34,134870.888758419,"mid","F"
8525,74,40,34,91980.1925470993,"mid","F"
8526,132,107,25,1297.89249278406,"big","F"
8527,26,23,3,29941.3254308582,"mid","F"
8528,49,37,12,30746.6923075382,"mid","F"
8529,62,36,26,97214.9086127452,"mid","F"
8530,45,16,29,26701.2884185609,"mid","F"
8531,81,31,50,44849.2159094718,"mid","F"
8532,169,129,40,326124.883293498,"big","F"
8533,63,13,50,12756.8456388709,"mid","F"
8534,45,7,38,37751.4076871491,"mid","F"
8535,3,3,0,1158.49606760957,"small","F"
8536,97,40,57,223042.794066471,"mid","F"
8537,190,114,76,203685.217437286,"big","F"
8538,44,29,15,19544.8004124207,"mid","F"
8539,18,4,14,8900.48901602223,"mid","F"
8540,59,11,48,42737.0746875027,"mid","F"
8541,285,52,233,177192.900566021,"big","F"
8542,94,22,72,44546.2438298424,"mid","F"
8543,15,14,1,6028.37066387108,"mid","F"
8544,66,14,52,128482.988686371,"mid","F"
8545,78,34,44,212012.016328816,"mid","F"
8546,29,2,27,36153.1670141215,"mid","F"
8547,77,75,2,107912.275579214,"mid","F"
8548,43,23,20,28610.1846182657,"mid","F"
8549,152,40,112,174393.837460006,"big","F"
8550,216,75,141,657351.208304268,"big","F"
8551,89,64,25,75188.2191345151,"mid","F"
8552,18,14,4,27296.9936448225,"mid","F"
8553,67,19,48,41720.3610415898,"mid","F"
8554,120,92,28,110986.794737526,"big","F"
8555,30,9,21,42845.9412498273,"mid","F"
8556,141,31,110,3451.622148662,"big","F"
8557,174,145,29,353019.746690751,"big","F"
8558,132,119,13,221796.648374701,"big","F"
8559,1,1,0,926.835809299847,"small","F"
8560,238,168,70,23801.7047085282,"big","F"
8561,4,2,2,423.221501531749,"small","F"
8562,42,4,38,27011.0990327469,"mid","F"
8563,19,2,17,32365.5643727208,"mid","F"
8564,163,27,136,13381.375639924,"big","F"
8565,56,46,10,82271.7762970411,"mid","F"
8566,8,4,4,1207.60226172668,"small","F"
8567,119,37,82,249252.413931929,"big","F"
8568,22,1,21,35630.4750767395,"mid","F"
8569,25,22,3,76357.719269397,"mid","F"
8570,32,1,31,11932.5208598516,"mid","F"
8571,106,62,44,196799.344799855,"big","F"
8572,10,6,4,1208.08960279817,"small","F"
8573,117,115,2,99010.1546615149,"big","F"
8574,21,4,17,44235.1261034079,"mid","F"
8575,136,11,125,258840.383769515,"big","F"
8576,39,34,5,1891.78032157382,"mid","F"
8577,37,1,36,44936.8380120915,"mid","F"
8578,81,5,76,146087.328715401,"mid","F"
8579,62,44,18,12963.713715495,"mid","F"
8580,58,5,53,97737.4242069214,"mid","F"
8581,44,42,2,46114.6782250529,"mid","F"
8582,86,63,23,62936.9364887354,"mid","F"
8583,85,31,54,160025.250067103,"mid","F"
8584,11,1,10,8601.296850498,"mid","F"
8585,31,4,27,27464.2293748906,"mid","F"
8586,18,17,1,21487.1281600422,"mid","F"
8587,38,28,10,62984.3844394083,"mid","F"
8588,27,4,23,6559.47213328768,"mid","F"
8589,229,149,80,25755.2369108541,"big","F"
8590,3,2,1,9603.55630119768,"small","F"
8591,35,4,31,47930.650704293,"mid","F"
8592,67,15,52,152103.372120212,"mid","F"
8593,144,135,9,190475.070387895,"big","F"
8594,123,50,73,5084.86747542133,"big","F"
8595,90,14,76,112608.845602034,"mid","F"
8596,185,75,110,164045.52706827,"big","F"
8597,77,52,25,66213.5807862452,"mid","F"
8598,174,57,117,202521.092295434,"big","F"
8599,16,5,11,1230.87628754456,"mid","F"
8600,26,15,11,89489.0164077406,"mid","F"
8601,64,33,31,60014.6868923637,"mid","F"
8602,3,2,1,6505.25057224979,"small","F"
8603,107,51,56,145448.845273428,"big","F"
8604,106,102,4,329600.829836711,"big","F"
8605,92,2,90,19650.5081942206,"mid","F"
8606,46,7,39,36627.4705421117,"mid","F"
8607,190,180,10,92091.3166437406,"big","F"
8608,145,19,126,86156.1793339861,"big","F"
8609,38,13,25,3906.40417325069,"mid","F"
8610,142,102,40,366266.045299837,"big","F"
8611,11,6,5,23491.6071411721,"mid","F"
8612,3,1,2,2609.34261520127,"small","F"
8613,56,31,25,49465.856586844,"mid","F"
8614,113,108,5,26039.5829049008,"big","F"
8615,71,46,25,124178.893489287,"mid","F"
8616,2,0,2,5246.67154068414,"small","F"
8617,75,24,51,93155.8562518741,"mid","F"
8618,69,55,14,25333.5470330147,"mid","F"
8619,64,54,10,16341.3278556029,"mid","F"
8620,98,8,90,237742.932951386,"mid","F"
8621,10,0,10,20782.9628520592,"small","F"
8622,62,62,0,20110.8470022572,"mid","F"
8623,88,11,77,70731.5670942351,"mid","F"
8624,42,14,28,46485.3849183876,"mid","F"
8625,109,87,22,67743.4419617867,"big","F"
8626,44,21,23,38689.9883081364,"mid","F"
8627,44,10,34,5318.61997693034,"mid","F"
8628,85,79,6,5884.06933488673,"mid","F"
8629,115,53,62,39847.7283979444,"big","F"
8630,77,26,51,152871.115366056,"mid","F"
8631,94,66,28,56969.6075647508,"mid","F"
8632,30,8,22,11138.0910701231,"mid","F"
8633,62,44,18,99165.4067261249,"mid","F"
8634,91,9,82,46614.5794388059,"mid","F"
8635,2,1,1,1707.59558854342,"small","F"
8636,44,22,22,68621.6720304408,"mid","F"
8637,86,72,14,138725.155886535,"mid","F"
8638,16,2,14,30543.6643143985,"mid","F"
8639,55,44,11,84113.4430008291,"mid","F"
8640,110,83,27,108474.355124057,"big","F"
8641,38,5,33,71781.2179220705,"mid","F"
8642,31,26,5,60987.1223604883,"mid","F"
8643,51,15,36,3555.08309582803,"mid","F"
8644,210,13,197,192084.684009627,"big","F"
8645,24,20,4,5512.45890771146,"mid","F"
8646,38,31,7,64977.0090779135,"mid","F"
8647,56,42,14,66095.0118871286,"mid","F"
8648,82,60,22,57264.1570619469,"mid","F"
8649,56,36,20,25987.8618767692,"mid","F"
8650,39,33,6,20945.7251654694,"mid","F"
8651,159,75,84,246765.203625042,"big","F"
8652,43,6,37,87913.7875451072,"mid","F"
8653,74,21,53,118784.546515437,"mid","F"
8654,31,27,4,22047.0511404116,"mid","F"
8655,277,113,164,684451.600223217,"big","F"
8656,72,59,13,77053.8880625457,"mid","F"
8657,82,38,44,136440.436775389,"mid","F"
8658,109,50,59,4737.74616471841,"big","F"
8659,105,56,49,248855.429500262,"big","F"
8660,53,11,42,49731.3184787254,"mid","F"
8661,74,52,22,40839.3569199417,"mid","F"
8662,202,25,177,124871.55490607,"big","F"
8663,1,0,1,461.852531522186,"small","F"
8664,190,188,2,265513.842558812,"big","F"
8665,68,35,33,60002.8067163176,"mid","F"
8666,84,11,73,25458.1289962056,"mid","F"
8667,76,65,11,95585.3578305765,"mid","F"
8668,26,8,18,8226.1962637116,"mid","F"
8669,35,20,15,52841.954994355,"mid","F"
8670,108,32,76,161854.447283518,"big","F"
8671,28,17,11,42608.355801848,"mid","F"
8672,79,63,16,2147.2819998287,"mid","F"
8673,71,3,68,66854.9314629662,"mid","F"
8674,4,3,1,172.686864446095,"small","F"
8675,100,37,63,221682.59329398,"mid","F"
8676,88,71,17,1606.06382179283,"mid","F"
8677,125,78,47,60391.4294838332,"big","F"
8678,26,8,18,59321.2398532732,"mid","F"
8679,43,43,0,77189.1535864158,"mid","F"
8680,111,104,7,30877.6346414527,"big","F"
8681,274,203,71,408375.740966628,"big","F"
8682,137,20,117,273404.129456208,"big","F"
8683,109,62,47,433556.748003939,"big","F"
8684,45,39,6,52871.5707677817,"mid","F"
8685,133,24,109,43433.7285010156,"big","F"
8686,53,43,10,16443.269844775,"mid","F"
8687,27,0,27,6068.45836244075,"mid","F"
8688,119,76,43,63631.620601931,"big","F"
8689,107,43,64,80895.8278868348,"big","F"
8690,23,20,3,31936.2959861855,"mid","F"
8691,146,80,66,42690.7262174637,"big","F"
8692,71,15,56,111600.337127727,"mid","F"
8693,12,10,2,24859.3537964786,"mid","F"
8694,13,5,8,5049.31012569179,"mid","F"
8695,179,18,161,305775.248099272,"big","F"
8696,7,5,2,2752.22043670692,"small","F"
8697,12,7,5,28998.294965252,"mid","F"
8698,31,14,17,41455.511620497,"mid","F"
8699,81,77,4,62822.8507349665,"mid","F"
8700,239,22,217,153254.111639106,"big","F"
8701,181,109,72,136328.433784174,"big","F"
8702,43,39,4,46315.4928541647,"mid","F"
8703,24,9,15,39245.7491114353,"mid","F"
8704,13,3,10,20926.9378302512,"mid","F"
8705,39,2,37,5735.169432584,"mid","F"
8706,70,27,43,184128.613084183,"mid","F"
8707,121,46,75,51614.7017076771,"big","F"
8708,47,45,2,34537.3061877924,"mid","F"
8709,135,38,97,26312.5948801135,"big","F"
8710,185,10,175,1063.04186919127,"big","F"
8711,38,26,12,29304.1122214027,"mid","F"
8712,44,35,9,78156.2134481373,"mid","F"
8713,96,28,68,28157.9976742902,"mid","F"
8714,113,70,43,259882.75103907,"big","F"
8715,51,10,41,117362.715016952,"mid","F"
8716,187,187,0,376824.700741627,"big","F"
8717,117,29,88,189728.759419511,"big","F"
8718,126,83,43,2292.51049813597,"big","F"
8719,24,19,5,47712.6262914268,"mid","F"
8720,11,11,0,5251.49056940953,"mid","F"
8721,30,25,5,22235.93842844,"mid","F"
8722,230,5,225,1572.12835500141,"big","F"
8723,162,147,15,244542.739027878,"big","F"
8724,126,110,16,108231.942347233,"big","F"
8725,3,2,1,5396.88450409463,"small","F"
8726,65,60,5,14903.5663743071,"mid","F"
8727,33,28,5,30720.9984839216,"mid","F"
8728,19,18,1,6573.0125680475,"mid","F"
8729,178,0,178,193875.552339878,"big","F"
8730,143,74,69,327849.737532161,"big","F"
8731,138,61,77,128489.016287926,"big","F"
8732,90,45,45,23093.6039090169,"mid","F"
8733,77,58,19,8467.91122386586,"mid","F"
8734,125,36,89,84765.0812065648,"big","F"
8735,85,62,23,14259.9477689975,"mid","F"
8736,82,78,4,75048.2490681274,"mid","F"
8737,95,53,42,134615.181553048,"mid","F"
8738,79,37,42,112205.670116741,"mid","F"
8739,119,73,46,67.1204773906761,"big","F"
8740,81,68,13,27443.1969072249,"mid","F"
8741,4,0,4,9763.54005279703,"small","F"
8742,146,126,20,235444.102872626,"big","F"
8743,17,3,14,42611.9368380419,"mid","F"
8744,70,57,13,53222.8943394651,"mid","F"
8745,42,31,11,25873.7310479943,"mid","F"
8746,77,77,0,120718.215300391,"mid","F"
8747,51,4,47,65635.2856919778,"mid","F"
8748,179,68,111,182179.942595908,"big","F"
8749,65,58,7,31061.1669627244,"mid","F"
8750,31,8,23,95461.9435723584,"mid","F"
8751,211,141,70,112369.138969178,"big","F"
8752,66,45,21,127870.35456323,"mid","F"
8753,85,14,71,21663.2070599393,"mid","F"
8754,70,33,37,102714.885500127,"mid","F"
8755,86,4,82,104250.269127682,"mid","F"
8756,91,24,67,88950.1048329438,"mid","F"
8757,58,56,2,113648.174153253,"mid","F"
8758,25,6,19,51871.0136087883,"mid","F"
8759,175,21,154,170349.343318116,"big","F"
8760,43,4,39,82945.0447977499,"mid","F"
8761,41,1,40,57342.7095954597,"mid","F"
8762,17,12,5,8927.88631516505,"mid","F"
8763,95,22,73,60102.8641642596,"mid","F"
8764,50,35,15,79750.3187881374,"mid","F"
8765,25,25,0,33352.8007246723,"mid","F"
8766,196,180,16,180910.548755544,"big","F"
8767,95,47,48,85434.6956858409,"mid","F"
8768,21,11,10,28651.7918402958,"mid","F"
8769,178,116,62,307533.755293636,"big","F"
8770,100,17,83,108752.283049642,"mid","F"
8771,69,39,30,178477.751152771,"mid","F"
8772,62,21,41,64528.463602997,"mid","F"
8773,21,12,9,85787.5046934329,"mid","F"
8774,65,59,6,89830.9244209356,"mid","F"
8775,125,58,67,108280.844441216,"big","F"
8776,85,22,63,136640.57518261,"mid","F"
8777,97,91,6,2195.86288339477,"mid","F"
8778,145,33,112,293798.710052057,"big","F"
8779,15,0,15,25568.5141797217,"mid","F"
8780,70,56,14,80815.3950129083,"mid","F"
8781,28,1,27,10637.9449847489,"mid","F"
8782,69,41,28,1962.95618291744,"mid","F"
8783,34,23,11,77859.5850746442,"mid","F"
8784,61,43,18,115524.83581931,"mid","F"
8785,48,34,14,44800.4714861891,"mid","F"
8786,99,94,5,190284.927635541,"mid","F"
8787,70,59,11,29493.209295659,"mid","F"
8788,178,101,77,256136.154549845,"big","F"
8789,278,30,248,532614.491072173,"big","F"
8790,56,22,34,91711.3171126879,"mid","F"
8791,58,53,5,75917.099630667,"mid","F"
8792,159,149,10,16121.0031388828,"big","F"
8793,45,31,14,1776.29857380253,"mid","F"
8794,15,6,9,4087.37069210331,"mid","F"
8795,102,11,91,211922.98137906,"big","F"
8796,108,9,99,48224.627151306,"big","F"
8797,60,8,52,19210.9291750379,"mid","F"
8798,108,30,78,23580.4798984861,"big","F"
8799,76,23,53,101028.455490269,"mid","F"
8800,15,12,3,23660.55114735,"mid","F"
8801,94,77,17,91624.0874692389,"mid","F"
8802,148,54,94,422278.401794226,"big","F"
8803,111,103,8,47548.1703498788,"big","F"
8804,89,84,5,54436.88462944,"mid","F"
8805,116,47,69,192941.805970324,"big","F"
8806,16,2,14,8503.20033075286,"mid","F"
8807,38,0,38,34839.2507629885,"mid","F"
8808,20,10,10,48664.8292169853,"mid","F"
8809,47,46,1,153879.941038753,"mid","F"
8810,114,74,40,138992.051779623,"big","F"
8811,116,75,41,87504.0919354727,"big","F"
8812,140,60,80,140512.203732742,"big","F"
8813,76,63,13,27438.719700204,"mid","F"
8814,211,185,26,456276.541513467,"big","F"
8815,102,76,26,73954.4749549843,"big","F"
8816,41,19,22,29012.2374121919,"mid","F"
8817,121,76,45,12021.5400121999,"big","F"
8818,17,8,9,8069.90239219237,"mid","F"
8819,92,46,46,69891.9713291318,"mid","F"
8820,130,30,100,12696.9428485614,"big","F"
8821,138,27,111,379879.201858704,"big","F"
8822,246,209,37,290253.732324199,"big","F"
8823,29,8,21,47931.6593460219,"mid","F"
8824,102,72,30,94825.5995421163,"big","F"
8825,168,90,78,59387.7422409484,"big","F"
8826,50,8,42,81858.8394169452,"mid","F"
8827,85,61,24,296501.783861815,"mid","F"
8828,74,54,20,132693.122960496,"mid","F"
8829,6,0,6,12048.3130399606,"small","F"
8830,25,21,4,16021.3677150579,"mid","F"
8831,12,8,4,23136.5937788818,"mid","F"
8832,5,3,2,1644.79098311272,"small","F"
8833,102,18,84,132948.379973641,"big","F"
8834,204,75,129,166455.600299121,"big","F"
8835,207,93,114,405635.347577573,"big","F"
8836,4,2,2,3256.8637075229,"small","F"
8837,228,147,81,331348.732105489,"big","F"
8838,31,9,22,86859.4514680112,"mid","F"
8839,47,20,27,55874.2251288299,"mid","F"
8840,206,56,150,76576.6379520929,"big","F"
8841,40,12,28,38193.2010035029,"mid","F"
8842,53,45,8,33921.8890671572,"mid","F"
8843,39,38,1,9011.53856328971,"mid","F"
8844,111,84,27,175466.926522132,"big","F"
8845,2,0,2,5040.75859397024,"small","F"
8846,55,31,24,74559.4781927472,"mid","F"
8847,55,39,16,44042.8527123408,"mid","F"
8848,41,31,10,97966.7405019278,"mid","F"
8849,108,19,89,163711.453826932,"big","F"
8850,41,12,29,11695.7348808268,"mid","F"
8851,201,179,22,1323.86356939299,"big","F"
8852,3,3,0,1991.53073094231,"small","F"
8853,98,4,94,12373.829121051,"mid","F"
8854,46,16,30,74157.1127395337,"mid","F"
8855,140,111,29,352218.823198675,"big","F"
8856,38,32,6,58442.7643447238,"mid","F"
8857,101,11,90,56499.8521882334,"big","F"
8858,9,9,0,7422.31051689009,"small","F"
8859,129,47,82,12633.5208983005,"big","F"
8860,8,6,2,8629.5872827521,"small","F"
8861,179,73,106,248535.94676307,"big","F"
8862,262,105,157,536715.883231179,"big","F"
8863,112,13,99,217405.422444641,"big","F"
8864,191,150,41,96285.2080163665,"big","F"
8865,40,3,37,97402.1945186802,"mid","F"
8866,86,19,67,199991.257012523,"mid","F"
8867,8,7,1,7407.40280041247,"small","F"
8868,139,107,32,101419.538375526,"big","F"
8869,6,4,2,7585.11400264731,"small","F"
8870,152,44,108,216197.735996386,"big","F"
8871,66,40,26,185463.637853401,"mid","F"
8872,89,40,49,91589.8126839137,"mid","F"
8873,22,15,7,21542.95517964,"mid","F"
8874,44,9,35,23308.1286730574,"mid","F"
8875,133,2,131,70858.8783493682,"big","F"
8876,165,130,35,173425.714872598,"big","F"
8877,16,13,3,15058.5347242294,"mid","F"
8878,98,83,15,74152.0732761421,"mid","F"
8879,59,34,25,14813.6427832401,"mid","F"
8880,105,75,30,201950.99390744,"big","F"
8881,106,9,97,87829.2036079987,"big","F"
8882,23,3,20,17426.6201277338,"mid","F"
8883,71,27,44,58217.0357530356,"mid","F"
8884,7,1,6,12295.2419450366,"small","F"
8885,137,46,91,149682.270815229,"big","F"
8886,113,72,41,95167.7110707781,"big","F"
8887,16,14,2,6915.3355396906,"mid","F"
8888,74,39,35,105223.598043193,"mid","F"
8889,206,165,41,332342.027781901,"big","F"
8890,153,9,144,56307.4480004841,"big","F"
8891,149,147,2,357669.397180811,"big","F"
8892,168,109,59,223280.797933692,"big","F"
8893,20,11,9,19172.4128741317,"mid","F"
8894,127,3,124,113176.47254458,"big","F"
8895,138,63,75,163306.118386443,"big","F"
8896,158,122,36,317172.114649841,"big","F"
8897,209,21,188,143233.067916619,"big","F"
8898,86,47,39,19852.3448911501,"mid","F"
8899,38,24,14,46930.0663890999,"mid","F"
8900,143,79,64,153509.658961204,"big","F"
8901,74,0,74,97460.7338931462,"mid","F"
8902,49,7,42,67217.1981381161,"mid","F"
8903,85,82,3,198913.663067785,"mid","F"
8904,38,11,27,15384.0768955846,"mid","F"
8905,24,7,17,62546.2363987889,"mid","F"
8906,45,10,35,115108.827470104,"mid","F"
8907,155,96,59,245928.962264417,"big","F"
8908,111,89,22,134443.631124381,"big","F"
8909,121,28,93,83228.3545755032,"big","F"
8910,36,32,4,17590.5049331782,"mid","F"
8911,96,14,82,124801.673455383,"mid","F"
8912,60,12,48,54638.6822027668,"mid","F"
8913,93,31,62,227113.194135726,"mid","F"
8914,5,0,5,627.273240596728,"small","F"
8915,120,49,71,8296.52910255815,"big","F"
8916,9,9,0,368.679766496224,"small","F"
8917,136,98,38,20292.2458589283,"big","F"
8918,64,45,19,14603.9750607578,"mid","F"
8919,100,56,44,250800.090277901,"mid","F"
8920,102,80,22,80831.2988246644,"big","F"
8921,38,36,2,39298.4208731589,"mid","F"
8922,107,98,9,188323.290510535,"big","F"
8923,221,187,34,100029.666653671,"big","F"
8924,76,24,52,22947.0200945487,"mid","F"
8925,117,45,72,112308.758577622,"big","F"
8926,15,6,9,4499.79376536333,"mid","F"
8927,43,40,3,78848.73988295,"mid","F"
8928,30,26,4,43701.6928878908,"mid","F"
8929,93,92,1,53251.5808888297,"mid","F"
8930,29,5,24,54590.2672159255,"mid","F"
8931,21,21,0,14533.5205241403,"mid","F"
8932,177,92,85,98483.8528190237,"big","F"
8933,28,7,21,68711.1470049633,"mid","F"
8934,48,25,23,13025.4027147069,"mid","F"
8935,4,2,2,12596.3516013609,"small","F"
8936,11,4,7,14280.3764762888,"mid","F"
8937,167,22,145,418425.961086192,"big","F"
8938,109,85,24,28531.8539755635,"big","F"
8939,44,25,19,3749.04609460456,"mid","F"
8940,200,102,98,345934.560633012,"big","F"
8941,25,4,21,19063.4279327299,"mid","F"
8942,79,76,3,105815.320641566,"mid","F"
8943,64,50,14,98569.8750593155,"mid","F"
8944,105,7,98,278116.512360231,"big","F"
8945,114,111,3,111599.009570487,"big","F"
8946,129,36,93,98468.8755230447,"big","F"
8947,91,22,69,138184.417550568,"mid","F"
8948,5,4,1,6780.05287043347,"small","F"
8949,116,13,103,150069.902868512,"big","F"
8950,23,18,5,2975.59644929525,"mid","F"
8951,91,72,19,14390.414684437,"mid","F"
8952,80,62,18,222208.976806839,"mid","F"
8953,150,10,140,46930.1432303438,"big","F"
8954,72,12,60,83787.6330265661,"mid","F"
8955,124,35,89,153504.448044241,"big","F"
8956,229,15,214,171527.070878407,"big","F"
8957,50,18,32,19341.878937325,"mid","F"
8958,40,29,11,3005.84281810895,"mid","F"
8959,63,5,58,100826.821505923,"mid","F"
8960,82,59,23,3557.5452661574,"mid","F"
8961,200,50,150,338527.445380277,"big","F"
8962,21,16,5,28661.9320882529,"mid","F"
8963,114,81,33,105913.106657357,"big","F"
8964,255,118,137,582970.171659641,"big","F"
8965,128,43,85,114399.402765332,"big","F"
8966,26,0,26,39515.7341548771,"mid","F"
8967,168,54,114,312664.078528839,"big","F"
8968,21,8,13,10968.2355684649,"mid","F"
8969,89,31,58,280626.070117582,"mid","F"
8970,14,7,7,23717.2315451678,"mid","F"
8971,8,2,6,6094.87553845783,"small","F"
8972,153,72,81,137610.940000802,"big","F"
8973,179,176,3,36719.4603560437,"big","F"
8974,173,74,99,100141.663786935,"big","F"
8975,71,30,41,149647.807297742,"mid","F"
8976,42,37,5,45725.0466931097,"mid","F"
8977,85,35,50,201055.387730783,"mid","F"
8978,16,8,8,27026.16316935,"mid","F"
8979,40,32,8,2749.81011656311,"mid","F"
8980,18,4,14,18090.9973442664,"mid","F"
8981,26,0,26,23400.9362236809,"mid","F"
8982,76,31,45,121597.39928379,"mid","F"
8983,24,5,19,82553.0201742676,"mid","F"
8984,95,40,55,64477.0708206962,"mid","F"
8985,18,18,0,8684.03492155944,"mid","F"
8986,165,55,110,256536.242348226,"big","F"
8987,104,72,32,85713.7554585611,"big","F"
8988,7,5,2,3752.11157621786,"small","F"
8989,35,24,11,33780.4726582109,"mid","F"
8990,84,44,40,19634.1076943887,"mid","F"
8991,9,4,5,1871.92551761902,"small","F"
8992,148,140,8,188722.513359034,"big","F"
8993,169,92,77,52704.5709457744,"big","F"
8994,9,3,6,17152.5203611058,"small","F"
8995,45,29,16,66008.1149670964,"mid","F"
8996,59,27,32,6553.24175563857,"mid","F"
8997,64,11,53,41215.2637622521,"mid","F"
8998,165,51,114,257323.385873447,"big","F"
8999,63,50,13,122871.352829124,"mid","F"
9000,133,66,67,162105.921627728,"big","F"
9001,46,23,23,24847.722388547,"mid","F"
9002,90,38,52,53969.4667524443,"mid","F"
9003,39,33,6,48245.2818750652,"mid","F"
9004,44,12,32,14261.1686447067,"mid","F"
9005,135,72,63,205946.122666503,"big","F"
9006,101,79,22,153268.779177015,"big","F"
9007,124,119,5,28541.1489055597,"big","F"
9008,131,2,129,156476.425187509,"big","F"
9009,34,22,12,19973.3317666989,"mid","F"
9010,7,1,6,15069.3061976481,"small","F"
9011,32,9,23,13503.2333373402,"mid","F"
9012,45,17,28,61129.0429515521,"mid","F"
9013,104,53,51,137356.906854509,"big","F"
9014,65,55,10,114769.516910519,"mid","F"
9015,13,5,8,7893.54685013814,"mid","F"
9016,57,2,55,65666.7321934624,"mid","F"
9017,103,96,7,48141.3727806136,"big","F"
9018,70,50,20,149173.343892842,"mid","F"
9019,107,53,54,85626.399693242,"big","F"
9020,2,1,1,1484.00883592078,"small","F"
9021,28,19,9,38133.4488896046,"mid","F"
9022,59,2,57,136131.358867068,"mid","F"
9023,13,9,4,29677.9123824438,"mid","F"
9024,141,134,7,418887.493713307,"big","F"
9025,3,1,2,4224.15448020776,"small","F"
9026,19,11,8,5288.85052599233,"mid","F"
9027,32,23,9,7366.29363102347,"mid","F"
9028,79,30,49,49730.7156416738,"mid","F"
9029,184,53,131,190887.039325889,"big","F"
9030,42,4,38,78838.9077007744,"mid","F"
9031,134,40,94,173233.24992706,"big","F"
9032,95,38,57,122679.499216589,"mid","F"
9033,120,113,7,141540.604342307,"big","F"
9034,50,3,47,122035.128436723,"mid","F"
9035,68,58,10,133228.199268107,"mid","F"
9036,45,12,33,96023.5997073756,"mid","F"
9037,237,121,116,238498.12028447,"big","F"
9038,85,29,56,178588.396168148,"mid","F"
9039,54,2,52,96633.620202504,"mid","F"
9040,70,36,34,7020.22259126264,"mid","F"
9041,221,142,79,464102.053276289,"big","F"
9042,23,19,4,20554.5233834035,"mid","F"
9043,81,73,8,4586.19314181245,"mid","F"
9044,27,7,20,2540.76617575364,"mid","F"
9045,165,96,69,191016.139956337,"big","F"
9046,134,106,28,152111.713969459,"big","F"
9047,110,97,13,181300.794110844,"big","F"
9048,45,20,25,81974.2550182523,"mid","F"
9049,22,10,12,30057.8191301392,"mid","F"
9050,19,18,1,47593.3298079038,"mid","F"
9051,8,4,4,2530.61576616249,"small","F"
9052,18,3,15,44898.2960884633,"mid","F"
9053,86,44,42,4754.39771463188,"mid","F"
9054,63,45,18,50681.964330636,"mid","F"
9055,12,10,2,21733.3751198561,"mid","F"
9056,45,37,8,27917.0910501783,"mid","F"
9057,44,18,26,20100.7459100428,"mid","F"
9058,84,77,7,176777.863096508,"mid","F"
9059,118,104,14,450623.717423116,"big","F"
9060,48,12,36,96431.5311747302,"mid","F"
9061,25,0,25,17014.7631957244,"mid","F"
9062,110,74,36,75579.079681513,"big","F"
9063,126,81,45,53350.0577149477,"big","F"
9064,117,18,99,95239.5143036039,"big","F"
9065,91,47,44,8033.35655253083,"mid","F"
9066,103,53,50,33849.3405120347,"big","F"
9067,75,66,9,83614.014967492,"mid","F"
9068,68,36,32,99051.6469921514,"mid","F"
9069,1,0,1,871.171894929121,"small","F"
9070,99,34,65,301075.796277698,"mid","F"
9071,2,0,2,3303.02708841616,"small","F"
9072,22,2,20,11072.0544973536,"mid","F"
9073,76,31,45,24998.5820635053,"mid","F"
9074,73,43,30,160833.484923583,"mid","F"
9075,12,4,8,26289.319444868,"mid","F"
9076,123,58,65,116886.73746085,"big","F"
9077,31,1,30,21469.8571612602,"mid","F"
9078,42,22,20,5293.18121949109,"mid","F"
9079,37,10,27,18765.8690859441,"mid","F"
9080,160,20,140,161203.249950883,"big","F"
9081,144,48,96,276173.460090925,"big","F"
9082,50,8,42,33125.3741394911,"mid","F"
9083,96,83,13,211621.317324029,"mid","F"
9084,4,2,2,1169.30462779204,"small","F"
9085,71,8,63,47609.1624245448,"mid","F"
9086,20,20,0,37642.2469638176,"mid","F"
9087,259,26,233,245866.050031041,"big","F"
9088,76,54,22,72496.4668005185,"mid","F"
9089,192,146,46,190512.990109611,"big","F"
9090,77,39,38,34195.4506807028,"mid","F"
9091,230,74,156,39196.5580183543,"big","F"
9092,63,56,7,73254.2798231938,"mid","F"
9093,30,6,24,73908.0137445811,"mid","F"
9094,79,57,22,205563.158504906,"mid","F"
9095,63,19,44,38688.7077015462,"mid","F"
9096,34,24,10,42260.8168862643,"mid","F"
9097,222,213,9,321431.137945691,"big","F"
9098,228,221,7,626487.144862027,"big","F"
9099,13,7,6,7680.48499008865,"mid","F"
9100,100,46,54,144672.109334432,"mid","F"
9101,103,103,0,71203.8201237296,"big","F"
9102,141,15,126,79371.5119369921,"big","F"
9103,79,71,8,167042.001280404,"mid","F"
9104,37,35,2,66724.7939147601,"mid","F"
9105,156,108,48,298290.632720409,"big","F"
9106,168,106,62,140247.8006667,"big","F"
9107,93,29,64,78110.5177005211,"mid","F"
9108,85,77,8,63318.6292268446,"mid","F"
9109,47,32,15,105504.019210273,"mid","F"
9110,50,30,20,7137.75075397244,"mid","F"
9111,74,49,25,95772.6243140697,"mid","F"
9112,30,4,26,42346.2184179282,"mid","F"
9113,65,15,50,106509.305527104,"mid","F"
9114,10,6,4,10046.3553708964,"small","F"
9115,203,54,149,99003.211886761,"big","F"
9116,42,15,27,55549.5416891238,"mid","F"
9117,84,71,13,44764.2081901038,"mid","F"
9118,70,62,8,19217.2053289171,"mid","F"
9119,89,60,29,53450.2118061963,"mid","F"
9120,99,26,73,54978.2060897374,"mid","F"
9121,106,9,97,151861.335369337,"big","F"
9122,141,63,78,342391.586041874,"big","F"
9123,239,161,78,214970.814692179,"big","F"
9124,29,22,7,17135.7195304608,"mid","F"
9125,42,14,28,8236.02545612454,"mid","F"
9126,74,71,3,162937.353846814,"mid","F"
9127,8,7,1,3297.97652525849,"small","F"
9128,54,13,41,1763.48493429864,"mid","F"
9129,1,0,1,574.34301462247,"small","F"
9130,74,66,8,126593.283930371,"mid","F"
9131,99,47,52,183401.737486874,"mid","F"
9132,48,27,21,140397.822232769,"mid","F"
9133,31,28,3,65282.9689693612,"mid","F"
9134,17,13,4,3058.6374920625,"mid","F"
9135,18,13,5,9359.55192231491,"mid","F"
9136,48,47,1,32155.8692849414,"mid","F"
9137,76,29,47,79073.8444037607,"mid","F"
9138,25,3,22,7381.88661535109,"mid","F"
9139,211,112,99,195825.658538273,"big","F"
9140,30,20,10,71521.034047122,"mid","F"
9141,86,39,47,272097.423126108,"mid","F"
9142,50,25,25,92124.0537201595,"mid","F"
9143,67,52,15,53508.724104305,"mid","F"
9144,212,106,106,545242.267762232,"big","F"
9145,32,13,19,11527.1757399482,"mid","F"
9146,12,2,10,10061.1913840633,"mid","F"
9147,56,37,19,138561.09862622,"mid","F"
9148,133,8,125,77173.9054481545,"big","F"
9149,171,103,68,462613.926921309,"big","F"
9150,77,2,75,39869.4128885984,"mid","F"
9151,68,65,3,39450.2863874675,"mid","F"
9152,29,9,20,85576.6759746715,"mid","F"
9153,59,36,23,48305.2662220183,"mid","F"
9154,55,23,32,32670.1072818253,"mid","F"
9155,89,33,56,135993.271076587,"mid","F"
9156,22,20,2,12498.396618296,"mid","F"
9157,7,0,7,1370.76982524842,"small","F"
9158,35,9,26,33868.6259072608,"mid","F"
9159,99,95,4,124279.013730659,"mid","F"
9160,3,2,1,1511.33255661376,"small","F"
9161,16,10,6,29772.7519501019,"mid","F"
9162,50,17,33,43927.5585683403,"mid","F"
9163,57,2,55,1106.17191546439,"mid","F"
9164,17,12,5,5190.56259452041,"mid","F"
9165,279,121,158,495461.839775854,"big","F"
9166,41,19,22,57588.7554477149,"mid","F"
9167,27,24,3,3644.64833931137,"mid","F"
9168,55,27,28,69922.6711631918,"mid","F"
9169,33,10,23,62267.4989768547,"mid","F"
9170,44,17,27,80121.4792550173,"mid","F"
9171,54,0,54,133117.766159518,"mid","F"
9172,52,17,35,97900.0959841064,"mid","F"
9173,10,1,9,32155.6763563191,"small","F"
9174,137,99,38,118938.396986848,"big","F"
9175,139,81,58,285156.430669902,"big","F"
9176,42,24,18,3791.04641336607,"mid","F"
9177,70,18,52,83026.2892337799,"mid","F"
9178,21,21,0,38402.0101871849,"mid","F"
9179,21,10,11,5509.76004167783,"mid","F"
9180,31,4,27,89803.6612343981,"mid","F"
9181,176,29,147,229538.648088494,"big","F"
9182,226,116,110,647032.007531485,"big","F"
9183,229,55,174,74303.9890416098,"big","F"
9184,11,7,4,6566.33092831803,"mid","F"
9185,76,37,39,16137.9109388528,"mid","F"
9186,189,98,91,46069.2261120278,"big","F"
9187,95,20,75,68187.5037409943,"mid","F"
9188,126,29,97,74052.9952320319,"big","F"
9189,98,47,51,163500.448955386,"mid","F"
9190,63,30,33,88000.7536754638,"mid","F"
9191,5,5,0,8002.6223072207,"small","F"
9192,6,2,4,5891.24814898922,"small","F"
9193,187,36,151,373361.254447762,"big","F"
9194,145,74,71,422500.369709998,"big","F"
9195,85,70,15,143881.219772113,"mid","F"
9196,65,52,13,139198.334346766,"mid","F"
9197,12,8,4,11724.7626971321,"mid","F"
9198,138,65,73,146627.365629237,"big","F"
9199,24,4,20,5412.81854784847,"mid","F"
9200,92,3,89,56523.3656439297,"mid","F"
9201,81,30,51,47581.2584078632,"mid","F"
9202,242,209,33,213698.291471178,"big","F"
9203,67,47,20,66951.4642858274,"mid","F"
9204,224,89,135,379676.074734878,"big","F"
9205,12,10,2,11383.4010838838,"mid","F"
9206,112,56,56,52676.7471351408,"big","F"
9207,76,73,3,98770.7368744927,"mid","F"
9208,50,37,13,72803.9817929406,"mid","F"
9209,122,64,58,70151.8701774321,"big","F"
9210,6,1,5,8284.75351512148,"small","F"
9211,11,6,5,16692.9601800661,"mid","F"
9212,12,6,6,614.350660597931,"mid","F"
9213,85,53,32,75092.1849923729,"mid","F"
9214,2,1,1,3679.35207607594,"small","F"
9215,117,65,52,138280.190208722,"big","F"
9216,74,44,30,56192.0255234306,"mid","F"
9217,29,4,25,29396.6425336043,"mid","F"
9218,50,40,10,84338.4907494744,"mid","F"
9219,109,85,24,185944.303325003,"big","F"
9220,79,34,45,917.161112285115,"mid","F"
9221,160,63,97,138077.307066969,"big","F"
9222,164,26,138,505375.276230839,"big","F"
9223,42,7,35,99474.6119769346,"mid","F"
9224,4,2,2,2743.11518938362,"small","F"
9225,9,8,1,19211.1721691018,"small","F"
9226,54,35,19,43693.0160864047,"mid","F"
9227,105,5,100,173485.924083129,"big","F"
9228,243,107,136,331552.851978779,"big","F"
9229,83,78,5,9876.46490006199,"mid","F"
9230,99,48,51,143382.980405682,"mid","F"
9231,275,136,139,11905.7651999518,"big","F"
9232,312,144,168,186329.04707497,"big","F"
9233,49,24,25,1620.38782584716,"mid","F"
9234,228,156,72,346134.037475679,"big","F"
9235,55,12,43,79147.7547889418,"mid","F"
9236,33,25,8,32253.3463547109,"mid","F"
9237,56,27,29,22637.2895738113,"mid","F"
9238,109,34,75,113301.224571054,"big","F"
9239,84,52,32,188251.417761443,"mid","F"
9240,16,12,4,58853.0887816408,"mid","F"
9241,135,75,60,272872.815421236,"big","F"
9242,182,97,85,176891.463723285,"big","F"
9243,9,8,1,6123.77556034121,"small","F"
9244,66,4,62,139335.076799276,"mid","F"
9245,57,47,10,58913.5486980395,"mid","F"
9246,14,14,0,24946.4344776756,"mid","F"
9247,67,13,54,104243.250288634,"mid","F"
9248,40,14,26,82651.0569717599,"mid","F"
9249,215,106,109,354932.827163512,"big","F"
9250,45,5,40,6877.93667736282,"mid","F"
9251,104,26,78,239027.885051311,"big","F"
9252,139,22,117,139105.967447675,"big","F"
9253,32,3,29,60526.230835377,"mid","F"
9254,43,16,27,47905.2616350921,"mid","F"
9255,43,23,20,61356.5322583848,"mid","F"
9256,39,22,17,23968.6478832008,"mid","F"
9257,75,1,74,225441.183396094,"mid","F"
9258,110,39,71,51605.7196474612,"big","F"
9259,96,35,61,14706.738527531,"mid","F"
9260,107,69,38,240630.770600515,"big","F"
9261,40,2,38,70672.0469920976,"mid","F"
9262,159,22,137,228076.674395992,"big","F"
9263,102,71,31,153234.53009165,"big","F"
9264,240,146,94,338097.855182915,"big","F"
9265,98,87,11,76723.0987668518,"mid","F"
9266,299,99,200,15624.5058692264,"big","F"
9267,27,18,9,62483.9872106745,"mid","F"
9268,93,45,48,31821.7730853395,"mid","F"
9269,39,34,5,27296.2174375715,"mid","F"
9270,9,3,6,5917.19902049608,"small","F"
9271,96,39,57,20917.3825093271,"mid","F"
9272,36,13,23,9467.96705815256,"mid","F"
9273,44,36,8,42298.7874100187,"mid","F"
9274,9,9,0,30650.3853911504,"small","F"
9275,215,139,76,521805.292481901,"big","F"
9276,13,9,4,8503.92494113408,"mid","F"
9277,69,63,6,71051.3340521804,"mid","F"
9278,43,34,9,60137.7998191889,"mid","F"
9279,37,31,6,16578.2530702449,"mid","F"
9280,151,120,31,129374.497315429,"big","F"
9281,1,0,1,2534.74315826587,"small","F"
9282,159,19,140,475237.023505736,"big","F"
9283,149,31,118,115699.326906651,"big","F"
9284,93,62,31,178382.440951737,"mid","F"
9285,125,58,67,173901.30599582,"big","F"
9286,27,18,9,23339.6195488164,"mid","F"
9287,50,23,27,25116.8685070754,"mid","F"
9288,168,48,120,269438.479614533,"big","F"
9289,26,11,15,33282.9951811727,"mid","F"
9290,49,32,17,75437.0298890833,"mid","F"
9291,2,2,0,1905.07523093276,"small","F"
9292,110,52,58,94666.9705275177,"big","F"
9293,7,4,3,12638.9661486667,"small","F"
9294,70,7,63,64606.2032415156,"mid","F"
9295,82,68,14,103982.491417647,"mid","F"
9296,22,12,10,4417.5707594114,"mid","F"
9297,92,23,69,64912.458527499,"mid","F"
9298,121,7,114,330477.829100944,"big","F"
9299,10,2,8,14608.564795222,"small","F"
9300,87,38,49,72775.539395317,"mid","F"
9301,106,25,81,319082.687936896,"big","F"
9302,51,31,20,5391.78417737481,"mid","F"
9303,24,10,14,28581.0460610712,"mid","F"
9304,55,44,11,52237.5816138178,"mid","F"
9305,83,24,59,14666.7367572314,"mid","F"
9306,163,155,8,270104.675459635,"big","F"
9307,4,0,4,8848.92960622385,"small","F"
9308,139,24,115,386106.647556238,"big","F"
9309,64,17,47,142065.669602045,"mid","F"
9310,132,16,116,234495.121172612,"big","F"
9311,1,0,1,96.2746809076458,"small","F"
9312,33,28,5,27858.0177403755,"mid","F"
9313,19,9,10,663.93393460833,"mid","F"
9314,125,39,86,329562.171187469,"big","F"
9315,58,45,13,149156.517557715,"mid","F"
9316,19,1,18,24394.2177525142,"mid","F"
9317,24,9,15,44952.8520151162,"mid","F"
9318,230,179,51,344195.834318113,"big","F"
9319,126,125,1,73202.2363713289,"big","F"
9320,18,5,13,34983.7992590359,"mid","F"
9321,26,19,7,68892.0972100285,"mid","F"
9322,63,43,20,53081.5883152606,"mid","F"
9323,148,141,7,256517.954732388,"big","F"
9324,52,19,33,7979.79144696705,"mid","F"
9325,294,10,284,177379.436413037,"big","F"
9326,34,12,22,92608.8908423064,"mid","F"
9327,111,30,81,122567.477499629,"big","F"
9328,102,9,93,182361.47063934,"big","F"
9329,165,158,7,24116.3797735306,"big","F"
9330,132,92,40,33149.9490485645,"big","F"
9331,35,20,15,95732.1765515177,"mid","F"
9332,19,18,1,1948.50673462766,"mid","F"
9333,68,66,2,4916.15881915208,"mid","F"
9334,57,21,36,156770.772591233,"mid","F"
9335,2,0,2,4963.88558833514,"small","F"
9336,101,57,44,65795.1300380938,"big","F"
9337,114,21,93,80660.3207760544,"big","F"
9338,18,18,0,3262.61984619572,"mid","F"
9339,50,45,5,84759.4154665762,"mid","F"
9340,20,7,13,3009.33790518222,"mid","F"
9341,76,33,43,47319.2339776823,"mid","F"
9342,45,12,33,54142.9839239647,"mid","F"
9343,195,101,94,20920.0797141466,"big","F"
9344,50,38,12,67946.6776867337,"mid","F"
9345,84,15,69,96666.3079285478,"mid","F"
9346,41,19,22,5776.5847389247,"mid","F"
9347,14,9,5,15448.1918455933,"mid","F"
9348,31,24,7,11420.27767533,"mid","F"
9349,66,39,27,45338.2671008785,"mid","F"
9350,120,29,91,82559.1407416967,"big","F"
9351,20,20,0,14393.6436176296,"mid","F"
9352,162,47,115,42423.778368156,"big","F"
9353,55,54,1,40482.2626425802,"mid","F"
9354,77,67,10,29350.0703275941,"mid","F"
9355,146,120,26,68583.7452005371,"big","F"
9356,158,9,149,58378.5346451264,"big","F"
9357,122,80,42,185739.572228623,"big","F"
9358,141,87,54,64421.8963080348,"big","F"
9359,63,30,33,123783.348139415,"mid","F"
9360,84,21,63,95291.2062393184,"mid","F"
9361,54,40,14,155052.861727637,"mid","F"
9362,105,14,91,214171.802565933,"big","F"
9363,23,3,20,19465.4148555173,"mid","F"
9364,162,30,132,4962.12025549188,"big","F"
9365,297,35,262,10745.7841873282,"big","F"
9366,105,55,50,212403.794545122,"big","F"
9367,205,33,172,91385.2124477473,"big","F"
9368,63,55,8,33286.8260147979,"mid","F"
9369,17,10,7,13883.0922032597,"mid","F"
9370,128,81,47,23704.8779155643,"big","F"
9371,180,166,14,253545.211619336,"big","F"
9372,54,21,33,24455.6098816043,"mid","F"
9373,158,155,3,119492.374210058,"big","F"
9374,50,41,9,36106.8853645847,"mid","F"
9375,169,163,6,20790.3322382822,"big","F"
9376,65,38,27,319.396896595636,"mid","F"
9377,25,8,17,21724.4610663391,"mid","F"
9378,99,72,27,128719.536733116,"mid","F"
9379,59,27,32,19507.9957422154,"mid","F"
9380,49,9,40,101772.207033035,"mid","F"
9381,45,37,8,27477.1968621476,"mid","F"
9382,131,108,23,234996.741897078,"big","F"
9383,70,16,54,141186.233399759,"mid","F"
9384,66,27,39,90170.5434541606,"mid","F"
9385,81,16,65,40929.3543732391,"mid","F"
9386,241,122,119,311644.613663108,"big","F"
9387,184,157,27,318745.724350686,"big","F"
9388,43,7,36,60191.9030829073,"mid","F"
9389,91,49,42,165489.95609217,"mid","F"
9390,51,47,4,17737.1823777696,"mid","F"
9391,38,18,20,62308.1040310798,"mid","F"
9392,43,1,42,114778.282096633,"mid","F"
9393,53,4,49,81980.0487459038,"mid","F"
9394,393,349,44,1347265.94122774,"big","F"
9395,138,77,61,178534.84922017,"big","F"
9396,76,5,71,103067.875542963,"mid","F"
9397,86,59,27,171128.086335347,"mid","F"
9398,56,34,22,77898.1602729835,"mid","F"
9399,11,7,4,6270.52842222778,"mid","F"
9400,203,128,75,369661.275425479,"big","F"
9401,40,2,38,44929.2248018145,"mid","F"
9402,108,29,79,22976.3755155701,"big","F"
9403,19,3,16,30862.0287488011,"mid","F"
9404,20,6,14,12767.2818798162,"mid","F"
9405,6,3,3,7482.03884238088,"small","F"
9406,74,70,4,9230.07969467898,"mid","F"
9407,77,36,41,114073.471608257,"mid","F"
9408,74,4,70,74604.3090942074,"mid","F"
9409,144,131,13,130676.918957049,"big","F"
9410,29,1,28,42120.4341099291,"mid","F"
9411,27,26,1,21646.8286630924,"mid","F"
9412,41,32,9,58175.116263837,"mid","F"
9413,39,15,24,36060.4085368374,"mid","F"
9414,59,45,14,46086.4256948226,"mid","F"
9415,186,122,64,297864.24179304,"big","F"
9416,10,9,1,14730.8372866047,"small","F"
9417,53,37,16,8723.60231167705,"mid","F"
9418,181,72,109,41336.9855448635,"big","F"
9419,132,112,20,87117.1222377376,"big","F"
9420,13,1,12,6579.00901292978,"mid","F"
9421,77,77,0,51339.8218891298,"mid","F"
9422,62,37,25,99133.9264768663,"mid","F"
9423,283,158,125,118863.002132488,"big","F"
9424,80,9,71,53131.931992056,"mid","F"
9425,31,8,23,9136.30877214363,"mid","F"
9426,74,52,22,104144.570979903,"mid","F"
9427,72,71,1,113422.16380771,"mid","F"
9428,85,38,47,66835.7982905812,"mid","F"
9429,33,20,13,2121.76306075743,"mid","F"
9430,36,12,24,73306.9060705158,"mid","F"
9431,152,22,130,366200.138349507,"big","F"
9432,141,57,84,233887.079281979,"big","F"
9433,83,21,62,130156.529281605,"mid","F"
9434,65,33,32,28363.9484477764,"mid","F"
9435,33,29,4,13247.593815609,"mid","F"
9436,79,77,2,17541.009817976,"mid","F"
9437,65,34,31,127419.809157362,"mid","F"
9438,196,130,66,418595.487807134,"big","F"
9439,151,24,127,499340.949887397,"big","F"
9440,50,27,23,54823.7814403276,"mid","F"
9441,87,6,81,174115.14942138,"mid","F"
9442,61,14,47,64922.3348609576,"mid","F"
9443,73,15,58,92728.3775257196,"mid","F"
9444,87,27,60,112620.543660119,"mid","F"
9445,111,83,28,2279.54980148096,"big","F"
9446,170,159,11,86390.5261515872,"big","F"
9447,67,63,4,98494.6964554079,"mid","F"
9448,133,113,20,79623.8316000907,"big","F"
9449,113,59,54,257683.78834702,"big","F"
9450,25,21,4,31039.9768190248,"mid","F"
9451,28,26,2,27542.9906011106,"mid","F"
9452,62,46,16,116020.283093273,"mid","F"
9453,63,62,1,13347.6244298222,"mid","F"
9454,41,1,40,53140.2534612195,"mid","F"
9455,100,98,2,154621.136584187,"mid","F"
9456,9,6,3,14148.4934798048,"small","F"
9457,7,4,3,18071.0801699848,"small","F"
9458,50,46,4,111998.847026712,"mid","F"
9459,74,58,16,146853.886754324,"mid","F"
9460,2,1,1,3416.51542696229,"small","F"
9461,162,59,103,46962.545517706,"big","F"
9462,159,58,101,344578.599310479,"big","F"
9463,30,27,3,48644.2431117872,"mid","F"
9464,23,0,23,29876.9521518668,"mid","F"
9465,6,3,3,17208.5429449617,"small","F"
9466,9,5,4,3621.00984353886,"small","F"
9467,7,6,1,6152.26169802364,"small","F"
9468,214,21,193,475912.066236627,"big","F"
9469,76,23,53,53191.0809181206,"mid","F"
9470,168,167,1,128720.969967803,"big","F"
9471,153,55,98,90666.331167444,"big","F"
9472,112,104,8,286467.350133786,"big","F"
9473,134,110,24,239652.520143507,"big","F"
9474,152,36,116,53683.308276557,"big","F"
9475,134,109,25,3499.65107294089,"big","F"
9476,7,7,0,1780.83729848788,"small","F"
9477,25,14,11,48041.3229416024,"mid","F"
9478,35,14,21,47411.5576485656,"mid","F"
9479,71,41,30,133937.950303784,"mid","F"
9480,148,13,135,139294.984656308,"big","F"
9481,16,1,15,7053.18532570624,"mid","F"
9482,2,2,0,1289.04025773896,"small","F"
9483,94,82,12,23666.3290201263,"mid","F"
9484,62,29,33,114668.7004554,"mid","F"
9485,199,39,160,160505.157206381,"big","F"
9486,68,14,54,15013.7261309189,"mid","F"
9487,55,14,41,73191.6478225672,"mid","F"
9488,34,11,23,39504.1902573605,"mid","F"
9489,87,13,74,220499.28746017,"mid","F"
9490,51,39,12,135720.850039221,"mid","F"
9491,14,0,14,23933.8661111236,"mid","F"
9492,39,12,27,7442.67473998813,"mid","F"
9493,20,15,5,5519.00113162523,"mid","F"
9494,120,79,41,177948.976152565,"big","F"
9495,8,5,3,4576.13705815151,"small","F"
9496,314,273,41,194410.957764286,"big","F"
9497,149,52,97,60847.195320463,"big","F"
9498,64,28,36,58595.5382681786,"mid","F"
9499,178,25,153,64544.3883299792,"big","F"
9500,138,81,57,245000.035371951,"big","F"
9501,12,1,11,20609.2362812866,"mid","F"
9502,10,0,10,11444.2457426524,"small","F"
9503,107,105,2,71365.5054565229,"big","F"
9504,48,14,34,26315.5481193038,"mid","F"
9505,101,4,97,61088.1279134967,"big","F"
9506,40,13,27,17143.3833581308,"mid","F"
9507,79,27,52,228280.817108125,"mid","F"
9508,106,37,69,21698.6922764956,"big","F"
9509,2,2,0,2814.52237184004,"small","F"
9510,276,243,33,49804.2210708924,"big","F"
9511,30,25,5,2105.27599895922,"mid","F"
9512,203,44,159,180427.849361087,"big","F"
9513,31,22,9,14284.2392314265,"mid","F"
9514,57,5,52,45053.1674952221,"mid","F"
9515,5,4,1,8019.80732558182,"small","F"
9516,128,90,38,10790.9823378132,"big","F"
9517,30,17,13,35343.590762313,"mid","F"
9518,67,20,47,55903.2422882981,"mid","F"
9519,110,104,6,109398.221194392,"big","F"
9520,119,28,91,43101.0974273827,"big","F"
9521,193,69,124,169205.892435781,"big","F"
9522,210,137,73,536961.579803761,"big","F"
9523,79,15,64,17848.6043645898,"mid","F"
9524,44,9,35,38087.7882940238,"mid","F"
9525,138,110,28,139771.265934341,"big","F"
9526,39,13,26,16232.6383879533,"mid","F"
9527,12,10,2,12518.4791133326,"mid","F"
9528,59,25,34,77133.0114706945,"mid","F"
9529,152,89,63,51596.397936542,"big","F"
9530,79,52,27,97781.9227581456,"mid","F"
9531,170,160,10,294375.405107968,"big","F"
9532,114,80,34,233235.906845655,"big","F"
9533,18,5,13,53605.8847796652,"mid","F"
9534,51,43,8,33810.4583331315,"mid","F"
9535,2,1,1,1880.8132659656,"small","F"
9536,129,87,42,27900.3377750873,"big","F"
9537,58,1,57,109289.2076897,"mid","F"
9538,15,2,13,13173.872804883,"mid","F"
9539,46,2,44,81359.351303547,"mid","F"
9540,105,95,10,7235.4914659119,"big","F"
9541,61,21,40,140655.032309105,"mid","F"
9542,64,31,33,80825.725251368,"mid","F"
9543,70,43,27,42030.049012243,"mid","F"
9544,69,13,56,113049.38929216,"mid","F"
9545,167,160,7,31831.3748997709,"big","F"
9546,46,19,27,44124.6051714084,"mid","F"
9547,87,42,45,77814.6354081499,"mid","F"
9548,19,5,14,25722.3918063688,"mid","F"
9549,29,23,6,45029.9066119608,"mid","F"
9550,79,58,21,31212.333678695,"mid","F"
9551,39,26,13,5376.15651179035,"mid","F"
9552,100,33,67,238280.230238295,"mid","F"
9553,34,30,4,38782.4571582007,"mid","F"
9554,169,26,143,232414.018042074,"big","F"
9555,16,6,10,24160.171635229,"mid","F"
9556,78,12,66,45396.7802029055,"mid","F"
9557,39,23,16,35068.807192142,"mid","F"
9558,49,18,31,76032.8222965618,"mid","F"
9559,29,1,28,54581.5208984233,"mid","F"
9560,106,5,101,114911.670712773,"big","F"
9561,103,67,36,21994.7135234183,"big","F"
9562,43,35,8,24464.3314169289,"mid","F"
9563,167,40,127,168262.220111729,"big","F"
9564,1,1,0,1530.25566941474,"small","F"
9565,5,4,1,1611.43979597521,"small","F"
9566,91,87,4,92463.7143930644,"mid","F"
9567,93,78,15,204641.15345342,"mid","F"
9568,98,62,36,55106.6511367509,"mid","F"
9569,6,5,1,2591.72254872056,"small","F"
9570,163,70,93,105898.746257889,"big","F"
9571,68,33,35,95355.3838765939,"mid","F"
9572,77,23,54,105669.141596744,"mid","F"
9573,105,67,38,193169.8997536,"big","F"
9574,110,48,62,296573.55811324,"big","F"
9575,28,11,17,42445.8677105667,"mid","F"
9576,112,44,68,318956.007978945,"big","F"
9577,76,45,31,109778.47881611,"mid","F"
9578,37,24,13,30458.434739776,"mid","F"
9579,25,12,13,28803.1198970142,"mid","F"
9580,84,7,77,117414.57317796,"mid","F"
9581,108,25,83,163536.704265763,"big","F"
9582,7,4,3,5434.56871887305,"small","F"
9583,17,17,0,13500.2721998229,"mid","F"
9584,2,1,1,1031.126299613,"small","F"
9585,51,42,9,10668.8938026934,"mid","F"
9586,97,33,64,23199.1252531102,"mid","F"
9587,15,12,3,26038.8847007439,"mid","F"
9588,8,0,8,13195.6165787326,"small","F"
9589,113,64,49,48849.9896430469,"big","F"
9590,92,10,82,183755.572641044,"mid","F"
9591,17,8,9,47862.6621680717,"mid","F"
9592,100,79,21,80403.446800115,"mid","F"
9593,135,94,41,47633.8286255783,"big","F"
9594,64,9,55,37151.3316786225,"mid","F"
9595,49,2,47,91095.1912489605,"mid","F"
9596,21,10,11,3946.78368794517,"mid","F"
9597,66,15,51,11465.6074345683,"mid","F"
9598,147,42,105,268746.071247753,"big","F"
9599,190,93,97,5177.17650511666,"big","F"
9600,75,16,59,137641.583240202,"mid","F"
9601,55,7,48,132271.335020093,"mid","F"
9602,30,8,22,49593.8316463554,"mid","F"
9603,38,31,7,11190.0397635876,"mid","F"
9604,76,69,7,114822.624565664,"mid","F"
9605,177,113,64,156527.125751678,"big","F"
9606,171,44,127,221949.805161943,"big","F"
9607,55,48,7,84915.1503613993,"mid","F"
9608,19,7,12,11259.7213332154,"mid","F"
9609,96,58,38,17036.2447013933,"mid","F"
9610,147,56,91,208859.93225583,"big","F"
9611,91,32,59,3557.61070517322,"mid","F"
9612,107,45,62,79389.0872901234,"big","F"
9613,140,90,50,213893.538826788,"big","F"
9614,17,9,8,2692.5062411002,"mid","F"
9615,92,15,77,286385.366179483,"mid","F"
9616,102,56,46,97878.9676645964,"big","F"
9617,98,22,76,181629.479383171,"mid","F"
9618,70,21,49,84072.6172550538,"mid","F"
9619,66,63,3,43140.1221966866,"mid","F"
9620,63,51,12,46653.2234005933,"mid","F"
9621,35,15,20,54779.5554103614,"mid","F"
9622,173,12,161,151812.674719362,"big","F"
9623,64,27,37,153475.100342305,"mid","F"
9624,118,1,117,212949.352120357,"big","F"
9625,28,24,4,7907.89253396607,"mid","F"
9626,16,16,0,18725.7846677845,"mid","F"
9627,60,38,22,89282.6471280321,"mid","F"
9628,139,106,33,133360.062887684,"big","F"
9629,20,5,15,24522.5013608548,"mid","F"
9630,28,24,4,93692.6843482699,"mid","F"
9631,140,5,135,44214.7220269291,"big","F"
9632,130,24,106,83123.5433567311,"big","F"
9633,19,18,1,30332.5445338007,"mid","F"
9634,82,74,8,2129.84183758649,"mid","F"
9635,116,12,104,43143.0419652057,"big","F"
9636,108,61,47,318648.406162011,"big","F"
9637,174,64,110,110240.296446894,"big","F"
9638,239,191,48,322757.341478005,"big","F"
9639,108,33,75,5294.05849477247,"big","F"
9640,35,16,19,39960.6033431092,"mid","F"
9641,12,9,3,32562.0737219779,"mid","F"
9642,65,1,64,150538.667157901,"mid","F"
9643,22,17,5,12921.4368255808,"mid","F"
9644,70,35,35,71938.8494747999,"mid","F"
9645,94,14,80,63810.9508228039,"mid","F"
9646,10,2,8,6512.12534743703,"small","F"
9647,52,38,14,2482.55055017548,"mid","F"
9648,48,31,17,25290.4472127798,"mid","F"
9649,111,52,59,6854.37733166571,"big","F"
9650,87,23,64,13461.2154978575,"mid","F"
9651,188,2,186,95281.9533072165,"big","F"
9652,102,31,71,81393.3037172888,"big","F"
9653,11,1,10,7612.04561431509,"mid","F"
9654,38,32,6,16620.1353438732,"mid","F"
9655,133,120,13,187013.362121932,"big","F"
9656,73,62,11,79045.7379499163,"mid","F"
9657,14,1,13,8890.29806227626,"mid","F"
9658,99,57,42,88306.2682820945,"mid","F"
9659,36,25,11,37831.8253498569,"mid","F"
9660,91,84,7,209197.329447252,"mid","F"
9661,73,39,34,109011.105863685,"mid","F"
9662,10,5,5,16958.5271957522,"small","F"
9663,62,20,42,82588.766683886,"mid","F"
9664,86,4,82,44683.2603542925,"mid","F"
9665,96,30,66,231863.904780334,"mid","F"
9666,215,2,213,302780.936233964,"big","F"
9667,128,123,5,52292.5028478444,"big","F"
9668,23,7,16,30526.620718882,"mid","F"
9669,20,10,10,10454.8674991912,"mid","F"
9670,220,175,45,411894.657343007,"big","F"
9671,61,55,6,95684.9763827238,"mid","F"
9672,19,8,11,30018.9368950034,"mid","F"
9673,42,28,14,32926.1079054152,"mid","F"
9674,102,28,74,156874.150476055,"big","F"
9675,148,40,108,360070.422786135,"big","F"
9676,188,144,44,175542.908940178,"big","F"
9677,65,55,10,67026.7592287149,"mid","F"
9678,64,38,26,76571.9917347048,"mid","F"
9679,37,1,36,119294.913284229,"mid","F"
9680,19,3,16,39386.6084508064,"mid","F"
9681,2,1,1,1810.92287493356,"small","F"
9682,145,144,1,1499.4973553029,"big","F"
9683,46,18,28,65966.9589241755,"mid","F"
9684,44,21,23,61160.9383512623,"mid","F"
9685,90,53,37,204114.582361465,"mid","F"
9686,2,1,1,890.265737500638,"small","F"
9687,69,17,52,58498.1240801131,"mid","F"
9688,45,37,8,38214.8168955962,"mid","F"
9689,79,45,34,77641.7056294426,"mid","F"
9690,150,19,131,474704.49871998,"big","F"
9691,7,2,5,9968.19370537198,"small","F"
9692,59,38,21,79762.1131634374,"mid","F"
9693,173,170,3,1005.24946443197,"big","F"
9694,65,39,26,88291.118449674,"mid","F"
9695,176,110,66,238913.181388029,"big","F"
9696,85,43,42,135820.485007074,"mid","F"
9697,201,115,86,455573.86113113,"big","F"
9698,86,23,63,70703.3255518644,"mid","F"
9699,32,9,23,48724.3167394105,"mid","F"
9700,9,2,7,26623.5110824721,"small","F"
9701,7,7,0,6010.36492871357,"small","F"
9702,259,223,36,331432.00709662,"big","F"
9703,11,4,7,8583.3210692919,"mid","F"
9704,62,11,51,41206.8135404858,"mid","F"
9705,74,39,35,19501.2336451316,"mid","F"
9706,10,9,1,7424.62483269106,"small","F"
9707,72,31,41,39236.120801182,"mid","F"
9708,125,101,24,182608.651465678,"big","F"
9709,121,107,14,386049.211605057,"big","F"
9710,18,13,5,16139.4057201207,"mid","F"
9711,49,29,20,31606.0070007271,"mid","F"
9712,124,113,11,1773.36836192669,"big","F"
9713,108,70,38,208611.560921949,"big","F"
9714,150,17,133,144181.776002373,"big","F"
9715,87,71,16,249776.89501502,"mid","F"
9716,63,8,55,33501.6746459125,"mid","F"
9717,24,10,14,37202.6511707434,"mid","F"
9718,48,38,10,139194.810932789,"mid","F"
9719,56,51,5,83368.19064761,"mid","F"
9720,22,2,20,27664.3192159552,"mid","F"
9721,36,23,13,15477.9659393428,"mid","F"
9722,18,11,7,45433.2722406338,"mid","F"
9723,138,79,59,10357.9769391818,"big","F"
9724,156,12,144,68008.4631047064,"big","F"
9725,11,8,3,17333.0626874488,"mid","F"
9726,77,8,69,162848.316660462,"mid","F"
9727,41,27,14,68797.4470669315,"mid","F"
9728,41,31,10,40967.496299872,"mid","F"
9729,239,115,124,637795.276504969,"big","F"
9730,67,55,12,38149.1500970071,"mid","F"
9731,184,79,105,368771.815710089,"big","F"
9732,90,42,48,62280.4398973532,"mid","F"
9733,25,15,10,9220.71160991727,"mid","F"
9734,42,42,0,37721.9331097692,"mid","F"
9735,48,9,39,105397.098712495,"mid","F"
9736,104,12,92,42308.8996481218,"big","F"
9737,110,14,96,198884.630530105,"big","F"
9738,24,12,12,14577.753355038,"mid","F"
9739,13,3,10,15480.6121533649,"mid","F"
9740,136,29,107,92148.5144918409,"big","F"
9741,4,4,0,9146.95517195819,"small","F"
9742,150,105,45,389186.926809672,"big","F"
9743,9,5,4,16420.1832388901,"small","F"
9744,214,196,18,50578.7962976611,"big","F"
9745,143,80,63,80025.6721050459,"big","F"
9746,80,12,68,122855.135055682,"mid","F"
9747,54,45,9,116388.081931559,"mid","F"
9748,18,11,7,8409.54229172236,"mid","F"
9749,66,65,1,100383.976970063,"mid","F"
9750,4,3,1,3417.80852816268,"small","F"
9751,34,14,20,11960.6341124126,"mid","F"
9752,18,10,8,34270.4189025735,"mid","F"
9753,89,60,29,189756.038410198,"mid","F"
9754,74,41,33,119206.698224185,"mid","F"
9755,138,102,36,59906.5796524697,"big","F"
9756,73,25,48,18106.6230770151,"mid","F"
9757,177,19,158,48402.1867011114,"big","F"
9758,9,6,3,1553.16510886207,"small","F"
9759,57,24,33,61842.8424592295,"mid","F"
9760,67,13,54,104944.445728794,"mid","F"
9761,50,47,3,8704.83727775213,"mid","F"
9762,115,30,85,110543.370187385,"big","F"
9763,80,2,78,110107.60237274,"mid","F"
9764,42,13,29,59122.6468099521,"mid","F"
9765,47,23,24,59122.7080805178,"mid","F"
9766,3,0,3,1596.10525432272,"small","F"
9767,164,55,109,215789.321333884,"big","F"
9768,43,30,13,89084.7956353466,"mid","F"
9769,66,15,51,20007.7820950126,"mid","F"
9770,29,27,2,39827.0800633453,"mid","F"
9771,88,66,22,136679.572064698,"mid","F"
9772,86,5,81,161485.050556676,"mid","F"
9773,66,14,52,111558.711471849,"mid","F"
9774,120,63,57,35964.6920634178,"big","F"
9775,36,30,6,75280.7299860912,"mid","F"
9776,102,14,88,8526.36845275,"big","F"
9777,9,6,3,11541.3527100618,"small","F"
9778,5,5,0,442.491357547937,"small","F"
9779,7,1,6,5195.44791784336,"small","F"
9780,4,0,4,3740.54822714938,"small","F"
9781,118,52,66,87995.4270761806,"big","F"
9782,11,0,11,8215.06216569802,"mid","F"
9783,98,68,30,9931.89427721119,"mid","F"
9784,141,85,56,92072.8037652606,"big","F"
9785,39,35,4,35619.5628740429,"mid","F"
9786,84,65,19,82724.5806387803,"mid","F"
9787,103,25,78,116867.592132308,"big","F"
9788,15,3,12,29111.2834075917,"mid","F"
9789,237,6,231,739132.111059988,"big","F"
9790,17,2,15,24247.4480669257,"mid","F"
9791,90,59,31,18823.7954796438,"mid","F"
9792,37,27,10,96243.2648124849,"mid","F"
9793,87,33,54,18209.8695708987,"mid","F"
9794,119,99,20,152904.176297326,"big","F"
9795,7,3,4,6080.13256829598,"small","F"
9796,20,14,6,20580.7424426433,"mid","F"
9797,102,45,57,135585.535186578,"big","F"
9798,61,51,10,19310.9036038801,"mid","F"
9799,107,51,56,111704.164876142,"big","F"
9800,5,5,0,4892.39652699545,"small","F"
9801,54,19,35,88072.7746920907,"mid","F"
9802,43,24,19,44973.4914401074,"mid","F"
9803,54,8,46,91873.3438350511,"mid","F"
9804,115,47,68,80835.9858210412,"big","F"
9805,268,100,168,17023.2767796462,"big","F"
9806,40,14,26,126515.153448505,"mid","F"
9807,109,59,50,84150.6922377709,"big","F"
9808,49,19,30,48711.3837707094,"mid","F"
9809,41,5,36,14668.0485404928,"mid","F"
9810,206,183,23,210016.595012301,"big","F"
9811,7,1,6,7286.77282141461,"small","F"
9812,133,1,132,152121.549463062,"big","F"
9813,1,1,0,775.735002841802,"small","F"
9814,47,19,28,4488.14054618349,"mid","F"
9815,29,24,5,43250.0798515558,"mid","F"
9816,143,104,39,322846.359891326,"big","F"
9817,17,17,0,2085.94555571143,"mid","F"
9818,18,1,17,15987.9941840331,"mid","F"
9819,36,23,13,15284.2782432604,"mid","F"
9820,14,4,10,7350.4493448148,"mid","F"
9821,1,1,0,760.711089039001,"small","F"
9822,1,1,0,1401.76430976183,"small","F"
9823,38,2,36,84301.082468216,"mid","F"
9824,229,177,52,68262.0120813838,"big","F"
9825,14,2,12,39630.2530520858,"mid","F"
9826,27,13,14,12014.9476482817,"mid","F"
9827,39,21,18,53046.9720666559,"mid","F"
9828,58,9,49,6244.89338979555,"mid","F"
9829,41,31,10,41769.2739554491,"mid","F"
9830,66,64,2,47972.850587049,"mid","F"
9831,18,8,10,1108.89908256368,"mid","F"
9832,55,37,18,29912.1666918505,"mid","F"
9833,90,51,39,29579.773897706,"mid","F"
9834,108,4,104,183122.531018577,"big","F"
9835,52,41,11,144390.54344327,"mid","F"
9836,87,31,56,29836.5939849465,"mid","F"
9837,22,6,16,26211.3131199568,"mid","F"
9838,53,35,18,62446.0343264727,"mid","F"
9839,87,86,1,185876.933352127,"mid","F"
9840,1,1,0,137.851485764256,"small","F"
9841,23,3,20,31266.1898949524,"mid","F"
9842,59,5,54,67468.1381644865,"mid","F"
9843,46,26,20,76475.8503536714,"mid","F"
9844,101,100,1,109872.352177967,"big","F"
9845,79,9,70,194080.344983676,"mid","F"
9846,57,54,3,69500.4494827004,"mid","F"
9847,22,8,14,33081.8155672501,"mid","F"
9848,110,31,79,199972.890276999,"big","F"
9849,65,28,37,82888.255284953,"mid","F"
9850,121,99,22,29615.3941299798,"big","F"
9851,56,18,38,34955.5532024133,"mid","F"
9852,174,43,131,276223.199740279,"big","F"
9853,160,89,71,117268.756125028,"big","F"
9854,53,18,35,16890.5956221278,"mid","F"
9855,44,4,40,75688.3928059371,"mid","F"
9856,77,51,26,95350.7082802294,"mid","F"
9857,84,24,60,66022.88869478,"mid","F"
9858,143,50,93,226439.88535851,"big","F"
9859,70,48,22,36376.5147382659,"mid","F"
9860,23,11,12,18408.4974768977,"mid","F"
9861,100,41,59,103075.634497836,"mid","F"
9862,32,6,26,76606.9060322596,"mid","F"
9863,13,11,2,1193.18134294218,"mid","F"
9864,6,1,5,13548.3338432227,"small","F"
9865,64,45,19,6034.65765425879,"mid","F"
9866,77,68,9,184799.95571542,"mid","F"
9867,167,22,145,277672.77918187,"big","F"
9868,52,14,38,76670.5294377491,"mid","F"
9869,45,34,11,12160.7011302828,"mid","F"
9870,23,9,14,14260.8754975546,"mid","F"
9871,85,7,78,55737.4953363486,"mid","F"
9872,25,15,10,14115.956809496,"mid","F"
9873,138,93,45,3563.44295252514,"big","F"
9874,28,4,24,54851.1993536316,"mid","F"
9875,39,3,36,58795.9520852309,"mid","F"
9876,44,39,5,55384.1167318966,"mid","F"
9877,62,2,60,39799.9472364564,"mid","F"
9878,201,107,94,189449.617480444,"big","F"
9879,21,20,1,33009.9385685786,"mid","F"
9880,47,17,30,34285.2155713503,"mid","F"
9881,11,2,9,2376.34783410415,"mid","F"
9882,141,136,5,290391.861408251,"big","F"
9883,175,164,11,472587.669653879,"big","F"
9884,57,23,34,62624.9386435851,"mid","F"
9885,60,8,52,9345.04743489795,"mid","F"
9886,119,12,107,142285.662380578,"big","F"
9887,176,77,99,179125.062494117,"big","F"
9888,189,16,173,310763.097471875,"big","F"
9889,146,52,94,96949.380490646,"big","F"
9890,148,101,47,81258.0350150023,"big","F"
9891,127,89,38,45664.9380338954,"big","F"
9892,53,50,3,5559.72502990241,"mid","F"
9893,46,21,25,78403.1442056517,"mid","F"
9894,74,7,67,51599.7282147377,"mid","F"
9895,72,52,20,51501.8658400812,"mid","F"
9896,137,43,94,159168.477647566,"big","F"
9897,175,24,151,95243.6586080151,"big","F"
9898,115,100,15,236562.365754376,"big","F"
9899,136,98,38,4685.89310884285,"big","F"
9900,50,6,44,149164.59864277,"mid","F"
9901,77,48,29,128746.286070646,"mid","F"
9902,114,98,16,76955.4604792331,"big","F"
9903,53,38,15,91900.2391864407,"mid","F"
9904,15,14,1,15546.95352397,"mid","F"
9905,32,30,2,37740.7809960451,"mid","F"
9906,76,48,28,123096.681577839,"mid","F"
9907,8,1,7,8304.98159418016,"small","F"
9908,84,17,67,158559.642821829,"mid","F"
9909,14,5,9,17886.3055471618,"mid","F"
9910,18,4,14,14068.8376505709,"mid","F"
9911,27,21,6,40722.8238807072,"mid","F"
9912,56,54,2,77368.0544947031,"mid","F"
9913,109,69,40,110957.344400214,"big","F"
9914,186,109,77,399635.120942553,"big","F"
9915,10,8,2,24530.3441053982,"small","F"
9916,114,38,76,38573.7307332583,"big","F"
9917,41,23,18,22078.1775049432,"mid","F"
9918,84,5,79,161423.043769017,"mid","F"
9919,138,44,94,225258.226155395,"big","F"
9920,82,0,82,184676.441124954,"mid","F"
9921,215,214,1,412574.287236353,"big","F"
9922,54,23,31,49575.6235309638,"mid","F"
9923,50,31,19,86006.7279740383,"mid","F"
9924,180,117,63,474145.080127886,"big","F"
9925,99,72,27,5973.98277246311,"mid","F"
9926,174,100,74,169683.11925688,"big","F"
9927,144,41,103,290338.603731934,"big","F"
9928,34,31,3,45591.7326234239,"mid","F"
9929,70,62,8,29111.8957480391,"mid","F"
9930,78,76,2,140552.93641303,"mid","F"
9931,92,46,46,113291.196557632,"mid","F"
9932,34,29,5,4147.67755580058,"mid","F"
9933,46,25,21,29997.9260554683,"mid","F"
9934,118,52,66,139116.874596348,"big","F"
9935,61,39,22,86336.099118555,"mid","F"
9936,18,2,16,11519.7421502739,"mid","F"
9937,91,59,32,204399.17483478,"mid","F"
9938,86,84,2,60998.2883953238,"mid","F"
9939,23,10,13,15843.4927722408,"mid","F"
9940,88,34,54,59594.0929743822,"mid","F"
9941,26,8,18,19645.9900837851,"mid","F"
9942,168,14,154,26718.9722340525,"big","F"
9943,28,23,5,35968.5502176621,"mid","F"
9944,35,35,0,767.884211672025,"mid","F"
9945,8,5,3,1888.88287010076,"small","F"
9946,96,79,17,108241.994279058,"mid","F"
9947,38,5,33,22502.3641249443,"mid","F"
9948,199,105,94,85815.166415668,"big","F"
9949,31,11,20,42094.924584575,"mid","F"
9950,71,63,8,38814.4485641279,"mid","F"
9951,7,1,6,5560.19044891843,"small","F"
9952,209,3,206,107550.858390653,"big","F"
9953,106,75,31,76037.9530513259,"big","F"
9954,65,27,38,36916.4147090648,"mid","F"
9955,107,94,13,130817.306506303,"big","F"
9956,97,85,12,154585.131502084,"mid","F"
9957,14,13,1,38458.4646057889,"mid","F"
9958,48,11,37,48346.8624503561,"mid","F"
9959,172,155,17,46748.2587932712,"big","F"
9960,88,56,32,73050.9734202595,"mid","F"
9961,116,87,29,244582.122390619,"big","F"
9962,94,80,14,295427.23815941,"mid","F"
9963,77,5,72,165674.748256162,"mid","F"
9964,80,69,11,2532.72575728619,"mid","F"
9965,21,20,1,36223.7148518475,"mid","F"
9966,5,2,3,11616.7623433855,"small","F"
9967,60,34,26,26779.7978359782,"mid","F"
9968,133,22,111,343878.171569003,"big","F"
9969,138,108,30,56722.4463573989,"big","F"
9970,74,14,60,67455.5313124228,"mid","F"
9971,127,22,105,319202.732896425,"big","F"
9972,140,61,79,120886.66440715,"big","F"
9973,104,28,76,29893.8383192346,"big","F"
9974,173,29,144,246564.616273773,"big","F"
9975,232,40,192,442576.560972046,"big","F"
9976,27,18,9,10454.1845356081,"mid","F"
9977,63,22,41,163521.550467385,"mid","F"
9978,131,32,99,377.064749366828,"big","F"
9979,60,20,40,13974.1603035533,"mid","F"
9980,64,36,28,75931.7236947642,"mid","F"
9981,29,5,24,7848.18956808736,"mid","F"
9982,90,52,38,65037.3759166453,"mid","F"
9983,19,19,0,10836.6137558705,"mid","F"
9984,105,30,75,67337.9452104378,"big","F"
9985,35,32,3,259.244490502324,"mid","F"
9986,158,38,120,89177.258765441,"big","F"
9987,23,9,14,16472.977560635,"mid","F"
9988,52,24,28,3416.94990609397,"mid","F"
9989,191,28,163,449249.393232758,"big","F"
9990,96,91,5,60052.0309248254,"mid","F"
9991,172,90,82,31114.0310669078,"big","F"
9992,46,26,20,13899.3813221109,"mid","F"
9993,31,7,24,67998.5412319302,"mid","F"
9994,61,4,57,74749.7197217327,"mid","F"
9995,52,41,11,50998.9956561532,"mid","F"
9996,117,94,23,214661.418566721,"big","F"
9997,80,2,78,88659.1294844221,"mid","F"
9998,13,9,4,13596.6156897357,"mid","F"
9999,105,64,41,30759.0069557101,"big","F"
10000,71,8,63,103179.743371384,"mid","F"
